ŻZW	ŻZW	subst:sg.pl:nom.gen.dat.acc.inst.loc.voc:n:ncol
ŻZW	ŻZW	subst:sg.pl:nom.gen.dat.acc.inst.loc.voc:m3
ŻW	ŻW:s2	subst:sg.pl:nom.gen.dat.acc.inst.loc.voc:f
ŻW	ŻW:s1	subst:sg.pl:nom.gen.dat.acc.inst.loc.voc:n:ncol
ŻOB	ŻOB	subst:sg.pl:nom.gen.dat.acc.inst.loc.voc:f
ŻOB	ŻOB	subst:sg:nom.acc:m3
ŻOBy	ŻOB	subst:pl:nom.acc.voc:m3
ŻOBu	ŻOB	subst:sg:gen:m3
ŻOBów	ŻOB	subst:pl:gen:m3
ŻOBowi	ŻOB	subst:sg:dat:m3
ŻOBom	ŻOB	subst:pl:dat:m3
ŻOBie	ŻOB	subst:sg:voc:m3
ŻOBie	ŻOB	subst:sg:loc:m3
ŻOBem	ŻOB	subst:sg:inst:m3
ŻOBami	ŻOB	subst:pl:inst:m3
ŻOBach	ŻOB	subst:pl:loc:m3
ZZ	ZZ	subst:sg:nom.acc:m3
ZZy	ZZ	subst:pl:nom.acc.voc:m3
ZZu	ZZ	subst:sg:gen:m3
ZZów	ZZ	subst:pl:gen:m3
ZZowi	ZZ	subst:sg:dat:m3
ZZom	ZZ	subst:pl:dat:m3
ZZety	ZZ	subst:pl:nom.acc.voc:m3
ZZetu	ZZ	subst:sg:gen:m3
ZZetów	ZZ	subst:pl:gen:m3
ZZetowi	ZZ	subst:sg:dat:m3
ZZetom	ZZ	subst:pl:dat:m3
ZZetem	ZZ	subst:sg:inst:m3
ZZetami	ZZ	subst:pl:inst:m3
ZZetach	ZZ	subst:pl:loc:m3
ZZem	ZZ	subst:sg:inst:m3
ZZecie	ZZ	subst:sg:voc:m3
ZZecie	ZZ	subst:sg:loc:m3
ZZami	ZZ	subst:pl:inst:m3
ZZach	ZZ	subst:pl:loc:m3
ZWZ	ZWZ	subst:sg:nom.acc:m3
ZWZy	ZWZ	subst:pl:nom.acc.voc:m3
ZWZu	ZWZ	subst:sg:gen:m3
ZWZów	ZWZ	subst:pl:gen:m3
ZWZowi	ZWZ	subst:sg:dat:m3
ZWZom	ZWZ	subst:pl:dat:m3
ZWZety	ZWZ	subst:pl:nom.acc.voc:m3
ZWZetu	ZWZ	subst:sg:gen:m3
ZWZetów	ZWZ	subst:pl:gen:m3
ZWZetowi	ZWZ	subst:sg:dat:m3
ZWZetom	ZWZ	subst:pl:dat:m3
ZWZetem	ZWZ	subst:sg:inst:m3
ZWZetami	ZWZ	subst:pl:inst:m3
ZWZetach	ZWZ	subst:pl:loc:m3
ZWZem	ZWZ	subst:sg:inst:m3
ZWZecie	ZWZ	subst:sg:voc:m3
ZWZecie	ZWZ	subst:sg:loc:m3
ZWZami	ZWZ	subst:pl:inst:m3
ZWZach	ZWZ	subst:pl:loc:m3
ZWM	ZWM	subst:sg:nom.acc:m3
ZWMy	ZWM	subst:pl:nom.acc.voc:m3
ZWMu	ZWM	subst:sg:gen:m3
ZWMów	ZWM	subst:pl:gen:m3
ZWMowi	ZWM	subst:sg:dat:m3
ZWMom	ZWM	subst:pl:dat:m3
ZWMie	ZWM	subst:sg:voc:m3
ZWMie	ZWM	subst:sg:loc:m3
ZWMem	ZWM	subst:sg:inst:m3
ZWMami	ZWM	subst:pl:inst:m3
ZWMach	ZWM	subst:pl:loc:m3
ZUS	ZUS	subst:sg:nom.acc:m3
ZUSy	ZUS	subst:pl:nom.acc.voc:m3
ZUSu	ZUS	subst:sg:gen:m3
ZUSów	ZUS	subst:pl:gen:m3
ZUSowi	ZUS	subst:sg:dat:m3
ZUSom	ZUS	subst:pl:dat:m3
ZUSie	ZUS	subst:sg:voc:m3
ZUSie	ZUS	subst:sg:loc:m3
ZUSem	ZUS	subst:sg:inst:m3
ZUSami	ZUS	subst:pl:inst:m3
ZUSach	ZUS	subst:pl:loc:m3
ZSZ	ZSZ	subst:sg.pl:nom.gen.dat.acc.inst.loc.voc:f
ZSZ	ZSZ	subst:sg:nom.acc:m3
ZSZy	ZSZ	subst:pl:nom.acc.voc:m3
ZSZu	ZSZ	subst:sg:gen:m3
ZSZów	ZSZ	subst:pl:gen:m3
ZSZowi	ZSZ	subst:sg:dat:m3
ZSZom	ZSZ	subst:pl:dat:m3
ZSZety	ZSZ	subst:pl:nom.acc.voc:m3
ZSZetu	ZSZ	subst:sg:gen:m3
ZSZetów	ZSZ	subst:pl:gen:m3
ZSZetowi	ZSZ	subst:sg:dat:m3
ZSZetom	ZSZ	subst:pl:dat:m3
ZSZetem	ZSZ	subst:sg:inst:m3
ZSZetami	ZSZ	subst:pl:inst:m3
ZSZetach	ZSZ	subst:pl:loc:m3
ZSZem	ZSZ	subst:sg:inst:m3
ZSZecie	ZSZ	subst:sg:voc:m3
ZSZecie	ZSZ	subst:sg:loc:m3
ZSZami	ZSZ	subst:pl:inst:m3
ZSZach	ZSZ	subst:pl:loc:m3
ZSSR	ZSSR	subst:sg.pl:nom.gen.dat.acc.inst.loc.voc:n:ncol
ZSSR	ZSSR	subst:sg.pl:nom.gen.dat.acc.inst.loc.voc:m3
ZSRR	ZSRR	subst:sg.pl:nom.gen.dat.acc.inst.loc.voc:n:ncol
ZSRR	ZSRR	subst:sg.pl:nom.gen.dat.acc.inst.loc.voc:m3
ZSP	ZSP	subst:sg.pl:nom.gen.dat.acc.inst.loc.voc:n:ncol
ZSP	ZSP	subst:sg.pl:nom.gen.dat.acc.inst.loc.voc:m3
ZSMP	ZSMP	subst:sg.pl:nom.gen.dat.acc.inst.loc.voc:n:ncol
ZSMP	ZSMP	subst:sg.pl:nom.gen.dat.acc.inst.loc.voc:m3
ZSL	ZSL	subst:sg.pl:nom.gen.dat.acc.inst.loc.voc:n:ncol
ZSL	ZSL	subst:sg:nom.acc:m3
ZSLu	ZSL	subst:sg:voc:m3
ZSLu	ZSL	subst:sg:loc:m3
ZSLu	ZSL	subst:sg:gen:m3
ZSLowi	ZSL	subst:sg:dat:m3
ZSLom	ZSL	subst:pl:dat:m3
ZSLi	ZSL	subst:pl:gen:m3
ZSLe	ZSL	subst:pl:nom.acc.voc:m3
ZSLem	ZSL	subst:sg:inst:m3
ZSLami	ZSL	subst:pl:inst:m3
ZSLach	ZSL	subst:pl:loc:m3
ZS	ZS	subst:sg:nom.acc:m3
ZSy	ZS	subst:pl:nom.acc.voc:m3
ZSu	ZS	subst:sg:gen:m3
ZSów	ZS	subst:pl:gen:m3
ZSowi	ZS	subst:sg:dat:m3
ZSom	ZS	subst:pl:dat:m3
ZSie	ZS	subst:sg:voc:m3
ZSie	ZS	subst:sg:loc:m3
ZSem	ZS	subst:sg:inst:m3
ZSami	ZS	subst:pl:inst:m3
ZSach	ZS	subst:pl:loc:m3
ZPB	ZPB	subst:sg.pl:nom.gen.dat.acc.inst.loc.voc:m3
ZOZ	ZOZ	subst:sg:nom.acc:m3
ZOZy	ZOZ	subst:pl:nom.acc.voc:m3
ZOZu	ZOZ	subst:sg:gen:m3
ZOZów	ZOZ	subst:pl:gen:m3
ZOZowi	ZOZ	subst:sg:dat:m3
ZOZom	ZOZ	subst:pl:dat:m3
ZOZie	ZOZ	subst:sg:voc:m3
ZOZie	ZOZ	subst:sg:loc:m3
ZOZem	ZOZ	subst:sg:inst:m3
ZOZami	ZOZ	subst:pl:inst:m3
ZOZach	ZOZ	subst:pl:loc:m3
ZOSP	ZOSP	subst:sg:nom.acc:m3
ZOSPy	ZOSP	subst:pl:nom.acc.voc:m3
ZOSPu	ZOSP	subst:sg:gen:m3
ZOSPów	ZOSP	subst:pl:gen:m3
ZOSPowi	ZOSP	subst:sg:dat:m3
ZOSPom	ZOSP	subst:pl:dat:m3
ZOSPie	ZOSP	subst:sg:voc:m3
ZOSPie	ZOSP	subst:sg:loc:m3
ZOSPem	ZOSP	subst:sg:inst:m3
ZOSPami	ZOSP	subst:pl:inst:m3
ZOSPach	ZOSP	subst:pl:loc:m3
ZOMO	ZOMO	subst:sg.pl:nom.gen.dat.acc.inst.loc.voc:n:ncol
ZOM	ZOM	subst:sg:nom.acc:m3
ZOMy	ZOM	subst:pl:nom.acc.voc:m3
ZOMu	ZOM	subst:sg:gen:m3
ZOMów	ZOM	subst:pl:gen:m3
ZOMowi	ZOM	subst:sg:dat:m3
ZOMom	ZOM	subst:pl:dat:m3
ZOMie	ZOM	subst:sg:voc:m3
ZOMie	ZOM	subst:sg:loc:m3
ZOMem	ZOM	subst:sg:inst:m3
ZOMami	ZOM	subst:pl:inst:m3
ZOMach	ZOM	subst:pl:loc:m3
ZNP	ZNP	subst:sg.pl:nom.gen.dat.acc.inst.loc.voc:n:ncol
ZNP	ZNP	subst:sg.pl:nom.gen.dat.acc.inst.loc.voc:m3
ZMS	ZMS	subst:sg:nom.acc:m3
ZMSy	ZMS	subst:pl:nom.acc.voc:m3
ZMSu	ZMS	subst:sg:gen:m3
ZMSów	ZMS	subst:pl:gen:m3
ZMSowi	ZMS	subst:sg:dat:m3
ZMSom	ZMS	subst:pl:dat:m3
ZMSie	ZMS	subst:sg:voc:m3
ZMSie	ZMS	subst:sg:loc:m3
ZMSem	ZMS	subst:sg:inst:m3
ZMSami	ZMS	subst:pl:inst:m3
ZMSach	ZMS	subst:pl:loc:m3
ZMP	ZMP	subst:sg.pl:nom.gen.dat.acc.inst.loc.voc:n:ncol
ZMP	ZMP	subst:sg.pl:nom.gen.dat.acc.inst.loc.voc:m3
ZLP	ZLP	subst:sg.pl:nom.gen.dat.acc.inst.loc.voc:n:ncol
ZLP	ZLP	subst:sg.pl:nom.gen.dat.acc.inst.loc.voc:m3
ZK	ZK	subst:sg.pl:nom.gen.dat.acc.inst.loc.voc:n:ncol
ZK	ZK	subst:sg.pl:nom.gen.dat.acc.inst.loc.voc:m3
ZHR	ZHR	subst:sg:nom.acc:m3
ZHRze	ZHR	subst:sg:voc:m3
ZHRze	ZHR	subst:sg:loc:m3
ZHRy	ZHR	subst:pl:nom.acc.voc:m3
ZHRu	ZHR	subst:sg:gen:m3
ZHRów	ZHR	subst:pl:gen:m3
ZHRowi	ZHR	subst:sg:dat:m3
ZHRom	ZHR	subst:pl:dat:m3
ZHRem	ZHR	subst:sg:inst:m3
ZHRami	ZHR	subst:pl:inst:m3
ZHRach	ZHR	subst:pl:loc:m3
ZHP	ZHP	subst:sg.pl:nom.gen.dat.acc.inst.loc.voc:n:ncol
ZHP	ZHP	subst:sg.pl:nom.gen.dat.acc.inst.loc.voc:m3
ZGH	ZGH	subst:sg.pl:nom.gen.dat.acc.inst.loc.voc:n:ncol
ZEA	ZEA	subst:pl:nom.gen.dat.acc.inst.loc.voc:n:pt
ZEA	ZEA	subst:pl:nom.gen.dat.acc.inst.loc.voc:n:pt
ZChN	ZChN	subst:sg.pl:nom.gen.dat.acc.inst.loc.voc:n:ncol
ZChN	ZChN	subst:sg:nom.acc:m3
ZChNy	ZChN	subst:pl:nom.acc.voc:m3
ZChNu	ZChN	subst:sg:gen:m3
ZChNów	ZChN	subst:pl:gen:m3
ZChNowi	ZChN	subst:sg:dat:m3
ZChNom	ZChN	subst:pl:dat:m3
ZChNie	ZChN	subst:sg:voc:m3
ZChNie	ZChN	subst:sg:loc:m3
ZChNem	ZChN	subst:sg:inst:m3
ZChNami	ZChN	subst:pl:inst:m3
ZChNach	ZChN	subst:pl:loc:m3
ZBOWiDzie	ZBOWiD	subst:sg:voc:m3
ZBOWiDzie	ZBOWiD	subst:sg:loc:m3
ZBOWiD	ZBOWiD	subst:sg:nom.acc:m3
ZBOWiDy	ZBOWiD	subst:pl:nom.acc.voc:m3
ZBOWiDu	ZBOWiD	subst:sg:gen:m3
ZBOWiDów	ZBOWiD	subst:pl:gen:m3
ZBOWiDowi	ZBOWiD	subst:sg:dat:m3
ZBOWiDom	ZBOWiD	subst:pl:dat:m3
ZBOWiDem	ZBOWiD	subst:sg:inst:m3
ZBOWiDami	ZBOWiD	subst:pl:inst:m3
ZBOWiDach	ZBOWiD	subst:pl:loc:m3
ZBoWiDzie	ZBoWiD	subst:sg:voc:m3
ZBoWiDzie	ZBoWiD	subst:sg:loc:m3
ZBoWiD	ZBoWiD	subst:sg:nom.acc:m3
ZBoWiDy	ZBoWiD	subst:pl:nom.acc.voc:m3
ZBoWiDu	ZBoWiD	subst:sg:gen:m3
ZBoWiDów	ZBoWiD	subst:pl:gen:m3
ZBoWiDowi	ZBoWiD	subst:sg:dat:m3
ZBoWiDom	ZBoWiD	subst:pl:dat:m3
ZBoWiDem	ZBoWiD	subst:sg:inst:m3
ZBoWiDami	ZBoWiD	subst:pl:inst:m3
ZBoWiDach	ZBoWiD	subst:pl:loc:m3
ZASP	ZASP	subst:sg:nom.acc:m3
ZASPy	ZASP	subst:pl:nom.acc.voc:m3
ZASPu	ZASP	subst:sg:gen:m3
ZASPów	ZASP	subst:pl:gen:m3
ZASPowi	ZASP	subst:sg:dat:m3
ZASPom	ZASP	subst:pl:dat:m3
ZASPie	ZASP	subst:sg:voc:m3
ZASPie	ZASP	subst:sg:loc:m3
ZASPem	ZASP	subst:sg:inst:m3
ZASPami	ZASP	subst:pl:inst:m3
ZASPach	ZASP	subst:pl:loc:m3
ZAIKS	ZAIKS	subst:sg:nom.acc:m3
ZAIKSy	ZAIKS	subst:pl:nom.acc.voc:m3
ZAIKSu	ZAIKS	subst:sg:gen:m3
ZAIKSów	ZAIKS	subst:pl:gen:m3
ZAIKSowi	ZAIKS	subst:sg:dat:m3
ZAIKSom	ZAIKS	subst:pl:dat:m3
ZAIKSie	ZAIKS	subst:sg:voc:m3
ZAIKSie	ZAIKS	subst:sg:loc:m3
ZAIKSem	ZAIKS	subst:sg:inst:m3
ZAIKSami	ZAIKS	subst:pl:inst:m3
ZAIKSach	ZAIKS	subst:pl:loc:m3
YWCA	YWCA	subst:sg.pl:nom.gen.dat.acc.inst.loc.voc:n:ncol
YWCA	YWCA	subst:sg.pl:nom.gen.dat.acc.inst.loc.voc:f
YMCA	YMCA	subst:sg.pl:nom.gen.dat.acc.inst.loc.voc:n:ncol
YMCA	YMCA	subst:sg.pl:nom.gen.dat.acc.inst.loc.voc:f
XML	XML	subst:sg:nom:m2
XML	XML	subst:sg:nom.acc:m3
XMLu	XML	subst:sg:voc:m3
XMLu	XML	subst:sg:voc:m2
XMLu	XML	subst:sg:loc:m3
XMLu	XML	subst:sg:loc:m2
XMLu	XML	subst:sg:gen:m3
XMLów	XML	subst:pl:gen:m2
XMLowi	XML	subst:sg:dat:m3
XMLowi	XML	subst:sg:dat:m2
XMLom	XML	subst:pl:dat:m3
XMLom	XML	subst:pl:dat:m2
XMLi	XML	subst:pl:gen:m3
XMLe	XML	subst:pl:nom.acc.voc:m3
XMLe	XML	subst:pl:nom.acc.voc:m2
XMLem	XML	subst:sg:inst:m3
XMLem	XML	subst:sg:inst:m2
XMLa	XML	subst:sg:gen:m2
XMLa	XML	subst:sg:gen.acc:m2
XMLami	XML	subst:pl:inst:m3
XMLami	XML	subst:pl:inst:m2
XMLach	XML	subst:pl:loc:m3
XMLach	XML	subst:pl:loc:m2
XBW	XBW	subst:sg.pl:nom.gen.dat.acc.inst.loc.voc:m1
XBW	XBW	depr:pl:nom.acc.voc:m2
WZiZT	WZiZT	subst:pl:nom.gen.dat.acc.inst.loc.voc:n:pt
WZA	WZA	subst:sg.pl:nom.gen.dat.acc.inst.loc.voc:n:ncol
WZ	WZ	subst:sg.pl:nom.gen.dat.acc.inst.loc.voc:f
WWW	WWW	subst:sg.pl:nom.gen.dat.acc.inst.loc.voc:f
WTO	WTO	subst:sg.pl:nom.gen.dat.acc.inst.loc.voc:n:ncol
WTO	WTO	subst:sg.pl:nom.gen.dat.acc.inst.loc.voc:m3
WTC	WTC	subst:sg.pl:nom.gen.dat.acc.inst.loc.voc:n:ncol
WSW	WSW	subst:sg.pl:nom.gen.dat.acc.inst.loc.voc:n:ncol
WSW	WSW	subst:sg.pl:nom.gen.dat.acc.inst.loc.voc:m3
WSP	WSP	subst:sg.pl:nom.gen.dat.acc.inst.loc.voc:n:ncol
WSP	WSP	subst:sg.pl:nom.gen.dat.acc.inst.loc.voc:f
WSMy	WSM	subst:pl:nom.acc.voc:m3
WSM	WSM	subst:sg:nom.acc:m3
WSMu	WSM	subst:sg:gen:m3
WSMów	WSM	subst:pl:gen:m3
WSMowi	WSM	subst:sg:dat:m3
WSMom	WSM	subst:pl:dat:m3
WSMie	WSM	subst:sg:voc:m3
WSMie	WSM	subst:sg:loc:m3
WSMem	WSM	subst:sg:inst:m3
WSMami	WSM	subst:pl:inst:m3
WSMach	WSM	subst:pl:loc:m3
WSK	WSK	subst:sg.pl:nom.gen.dat.acc.inst.loc.voc:n:ncol
WSK	WSK	subst:sg.pl:nom.gen.dat.acc.inst.loc.voc:f
WSiPy	WSiP	subst:pl:nom.acc.voc:m3
WSiP	WSiP	subst:sg:nom.acc:m3
WSiP	WSiP	subst:pl:nom.gen.dat.acc.inst.loc.voc:n:pt
WSiPu	WSiP	subst:sg:gen:m3
WSiPów	WSiP	subst:pl:gen:m3
WSiPowi	WSiP	subst:sg:dat:m3
WSiPom	WSiP	subst:pl:dat:m3
WSiPie	WSiP	subst:sg:voc:m3
WSiPie	WSiP	subst:sg:loc:m3
WSiPem	WSiP	subst:sg:inst:m3
WSiPami	WSiP	subst:pl:inst:m3
WSiPach	WSiP	subst:pl:loc:m3
WSI	WSI	subst:sg.pl:nom.gen.dat.acc.inst.loc.voc:n:ncol
WRONy	WRON	subst:pl:nom.acc.voc:m3
WRON	WRON	subst:sg.pl:nom.gen.dat.acc.inst.loc.voc:f
WRON	WRON	subst:sg:nom.acc:m3
WRONu	WRON	subst:sg:gen:m3
WRONów	WRON	subst:pl:gen:m3
WRONowi	WRON	subst:sg:dat:m3
WRONom	WRON	subst:pl:dat:m3
WRONie	WRON	subst:sg:voc:m3
WRONie	WRON	subst:sg:loc:m3
WRONem	WRON	subst:sg:inst:m3
WRONami	WRON	subst:pl:inst:m3
WRONach	WRON	subst:pl:loc:m3
WRN	WRN:s2	subst:sg.pl:nom.gen.dat.acc.inst.loc.voc:m3
WRNy	WRN:s1	subst:pl:nom.acc.voc:m3
WRN	WRN:s1	subst:sg.pl:nom.gen.dat.acc.inst.loc.voc:n:ncol
WRN	WRN:s1	subst:sg.pl:nom.gen.dat.acc.inst.loc.voc:f
WRN	WRN:s1	subst:sg:nom.acc:m3
WRNu	WRN:s1	subst:sg:gen:m3
WRNów	WRN:s1	subst:pl:gen:m3
WRNowi	WRN:s1	subst:sg:dat:m3
WRNom	WRN:s1	subst:pl:dat:m3
WRNie	WRN:s1	subst:sg:voc:m3
WRNie	WRN:s1	subst:sg:loc:m3
WRNem	WRN:s1	subst:sg:inst:m3
WRNami	WRN:s1	subst:pl:inst:m3
WRNach	WRN:s1	subst:pl:loc:m3
WP	WP	subst:sg.pl:nom.gen.dat.acc.inst.loc.voc:n:ncol
WOŚPy	WOŚP	subst:pl:nom.acc.voc:m3
WOŚP	WOŚP	subst:sg.pl:nom.gen.dat.acc.inst.loc.voc:f
WOŚP	WOŚP	subst:sg:nom.acc:m3
WOŚPu	WOŚP	subst:sg:gen:m3
WOŚPów	WOŚP	subst:pl:gen:m3
WOŚPowi	WOŚP	subst:sg:dat:m3
WOŚPom	WOŚP	subst:pl:dat:m3
WOŚPie	WOŚP	subst:sg:voc:m3
WOŚPie	WOŚP	subst:sg:loc:m3
WOŚPem	WOŚP	subst:sg:inst:m3
WOŚPami	WOŚP	subst:pl:inst:m3
WOŚPach	WOŚP	subst:pl:loc:m3
WOPRze	WOPR	subst:sg:voc:m3
WOPRze	WOPR	subst:sg:loc:m3
WOPRy	WOPR	subst:pl:nom.acc.voc:m3
WOPR	WOPR	subst:sg:nom.acc:m3
WOPRu	WOPR	subst:sg:gen:m3
WOPRów	WOPR	subst:pl:gen:m3
WOPRowi	WOPR	subst:sg:dat:m3
WOPRom	WOPR	subst:pl:dat:m3
WOPRem	WOPR	subst:sg:inst:m3
WOPRami	WOPR	subst:pl:inst:m3
WOPRach	WOPR	subst:pl:loc:m3
WOPy	WOP	subst:pl:nom.acc.voc:m3
WOP	WOP	subst:sg:nom.acc:m3
WOPu	WOP	subst:sg:gen:m3
WOPów	WOP	subst:pl:gen:m3
WOPowi	WOP	subst:sg:dat:m3
WOPom	WOP	subst:pl:dat:m3
WOPie	WOP	subst:sg:voc:m3
WOPie	WOP	subst:sg:loc:m3
WOPem	WOP	subst:sg:inst:m3
WOPami	WOP	subst:pl:inst:m3
WOPach	WOP	subst:pl:loc:m3
WNP	WNP	subst:sg.pl:nom.gen.dat.acc.inst.loc.voc:n:ncol
WNP	WNP	subst:sg.pl:nom.gen.dat.acc.inst.loc.voc:f
WMO	WMO	subst:sg.pl:nom.gen.dat.acc.inst.loc.voc:n:ncol
WMO	WMO	subst:sg.pl:nom.gen.dat.acc.inst.loc.voc:f
WKU	WKU	subst:sg.pl:nom.gen.dat.acc.inst.loc.voc:n:ncol
WKU	WKU	subst:sg.pl:nom.gen.dat.acc.inst.loc.voc:f
WKRze	WKR	subst:sg:voc:m3
WKRze	WKR	subst:sg:loc:m3
WKRy	WKR	subst:pl:nom.acc.voc:m3
WKR	WKR	subst:sg:nom.acc:m3
WKRu	WKR	subst:sg:gen:m3
WKRów	WKR	subst:pl:gen:m3
WKRowi	WKR	subst:sg:dat:m3
WKRom	WKR	subst:pl:dat:m3
WKRem	WKR	subst:sg:inst:m3
WKRami	WKR	subst:pl:inst:m3
WKRach	WKR	subst:pl:loc:m3
WKD	WKD	subst:sg.pl:nom.gen.dat.acc.inst.loc.voc:n:ncol
WiPy	WiP	subst:pl:nom.acc.voc:m3
WiP	WiP	subst:sg.pl:nom.gen.dat.acc.inst.loc.voc:m3
WiP	WiP	subst:sg:nom.acc:m3
WiPu	WiP	subst:sg:gen:m3
WiPów	WiP	subst:pl:gen:m3
WiPowi	WiP	subst:sg:dat:m3
WiPom	WiP	subst:pl:dat:m3
WiPie	WiP	subst:sg:voc:m3
WiPie	WiP	subst:sg:loc:m3
WiPem	WiP	subst:sg:inst:m3
WiPami	WiP	subst:pl:inst:m3
WiPach	WiP	subst:pl:loc:m3
WiNy	WiN	subst:pl:nom.acc.voc:m3
WiN	WiN	subst:sg:nom.acc:m3
WiNu	WiN	subst:sg:gen:m3
WiNów	WiN	subst:pl:gen:m3
WiNowi	WiN	subst:sg:dat:m3
WiNom	WiN	subst:pl:dat:m3
WiNie	WiN	subst:sg:voc:m3
WiNie	WiN	subst:sg:loc:m3
WiNem	WiN	subst:sg:inst:m3
WiNami	WiN	subst:pl:inst:m3
WiNach	WiN	subst:pl:loc:m3
WIG	WIG	subst:sg:nom.acc:m3
WIGu	WIG	subst:sg:voc:m3
WIGu	WIG	subst:sg:loc:m3
WIGu	WIG	subst:sg:gen:m3
WIGów	WIG	subst:pl:gen:m3
WIGowi	WIG	subst:sg:dat:m3
WIGom	WIG	subst:pl:dat:m3
WIGi	WIG	subst:pl:nom.acc.voc:m3
WIGiem	WIG	subst:sg:inst:m3
WIGami	WIG	subst:pl:inst:m3
WIGach	WIG	subst:pl:loc:m3
WHO	WHO	subst:sg.pl:nom.gen.dat.acc.inst.loc.voc:n:ncol
WFTU	WFTU	subst:sg.pl:nom.gen.dat.acc.inst.loc.voc:f
WFSW	WFSW	subst:sg.pl:nom.gen.dat.acc.inst.loc.voc:n:ncol
WFy	WF	subst:pl:nom.acc.voc:m3
WF	WF	subst:sg:nom.acc:m3
WFu	WF	subst:sg:gen:m3
WFów	WF	subst:pl:gen:m3
WFowi	WF	subst:sg:dat:m3
WFom	WF	subst:pl:dat:m3
WFie	WF	subst:sg:voc:m3
WFie	WF	subst:sg:loc:m3
WFem	WF	subst:sg:inst:m3
WFami	WF	subst:pl:inst:m3
WFach	WF	subst:pl:loc:m3
wfy	wf	subst:pl:nom.acc.voc:m3
wf	wf	subst:sg:nom.acc:m3
wfu	wf	subst:sg:gen:m3
wfów	wf	subst:pl:gen:m3
wfowi	wf	subst:sg:dat:m3
wfom	wf	subst:pl:dat:m3
wfie	wf	subst:sg:voc:m3
wfie	wf	subst:sg:loc:m3
wfem	wf	subst:sg:inst:m3
wfami	wf	subst:pl:inst:m3
wfach	wf	subst:pl:loc:m3
WEPy	WEP	subst:pl:nom.acc.voc:m3
WEP	WEP	subst:sg:nom.acc:m3
WEPu	WEP	subst:sg:gen:m3
WEPów	WEP	subst:pl:gen:m3
WEPowi	WEP	subst:sg:dat:m3
WEPom	WEP	subst:pl:dat:m3
WEPie	WEP	subst:sg:voc:m3
WEPie	WEP	subst:sg:loc:m3
WEPem	WEP	subst:sg:inst:m3
WEPami	WEP	subst:pl:inst:m3
WEPach	WEP	subst:pl:loc:m3
WC	WC	subst:sg.pl:nom.gen.dat.acc.inst.loc.voc:n:ncol
WBZy	WBZ	subst:pl:nom.acc.voc:m3
WBZ	WBZ	subst:sg:nom.acc:m3
WBZu	WBZ	subst:sg:gen:m3
WBZów	WBZ	subst:pl:gen:m3
WBZowi	WBZ	subst:sg:dat:m3
WBZom	WBZ	subst:pl:dat:m3
WBZety	WBZ	subst:pl:nom.acc.voc:m3
WBZetu	WBZ	subst:sg:gen:m3
WBZetów	WBZ	subst:pl:gen:m3
WBZetowi	WBZ	subst:sg:dat:m3
WBZetom	WBZ	subst:pl:dat:m3
WBZetem	WBZ	subst:sg:inst:m3
WBZetami	WBZ	subst:pl:inst:m3
WBZetach	WBZ	subst:pl:loc:m3
WBZem	WBZ	subst:sg:inst:m3
WBZecie	WBZ	subst:sg:voc:m3
WBZecie	WBZ	subst:sg:loc:m3
WBZami	WBZ	subst:pl:inst:m3
WBZach	WBZ	subst:pl:loc:m3
WBK	WBK	subst:sg.pl:nom.gen.dat.acc.inst.loc.voc:n:ncol
WBK	WBK	subst:sg.pl:nom.gen.dat.acc.inst.loc.voc:m3
WATy	WAT	subst:pl:nom.acc.voc:m3
WAT	WAT	subst:sg.pl:nom.gen.dat.acc.inst.loc.voc:m3
WAT	WAT	subst:sg:nom.acc:m3
WATu	WAT	subst:sg:gen:m3
WATów	WAT	subst:pl:gen:m3
WATowi	WAT	subst:sg:dat:m3
WATom	WAT	subst:pl:dat:m3
WATem	WAT	subst:sg:inst:m3
WATami	WAT	subst:pl:inst:m3
WATach	WAT	subst:pl:loc:m3
WAcie	WAT	subst:sg:voc:m3
Wacie	WAT	subst:sg:voc:m3
WAcie	WAT	subst:sg:loc:m3
Wacie	WAT	subst:sg:loc:m3
WACIE	WAT	subst:sg:voc:m3
WACIE	WAT	subst:sg:loc:m3
WAPy	WAP	subst:pl:nom.acc.voc:m3
WAP	WAP	subst:sg.pl:nom.gen.dat.acc.inst.loc.voc:m3
WAP	WAP	subst:sg:nom.acc:m3
WAPu	WAP	subst:sg:gen:m3
WAPów	WAP	subst:pl:gen:m3
WAPowi	WAP	subst:sg:dat:m3
WAPom	WAP	subst:pl:dat:m3
WAPie	WAP	subst:sg:voc:m3
WAPie	WAP	subst:sg:loc:m3
WAPem	WAP	subst:sg:inst:m3
WAPami	WAP	subst:pl:inst:m3
WAPach	WAP	subst:pl:loc:m3
WANy	WAN	subst:pl:nom.acc.voc:m3
WAN	WAN	subst:sg:nom.acc:m3
WANu	WAN	subst:sg:gen:m3
WANów	WAN	subst:pl:gen:m3
WANowi	WAN	subst:sg:dat:m3
WANom	WAN	subst:pl:dat:m3
WANie	WAN	subst:sg:voc:m3
WANie	WAN	subst:sg:loc:m3
WANem	WAN	subst:sg:inst:m3
WANami	WAN	subst:pl:inst:m3
WANach	WAN	subst:pl:loc:m3
VW	VW	subst:sg.pl:nom.gen.dat.acc.inst.loc.voc:n:ncol
VW	VW	subst:sg.pl:nom.gen.dat.acc.inst.loc.voc:m3
VIPy	VIP	depr:pl:nom.acc.voc:m2
VIP	VIP	subst:sg:nom:m1
VIPów	VIP	subst:pl:gen.acc:m1
VIPowi	VIP	subst:sg:dat:m1
VIPowie	VIP	subst:pl:nom.voc:m1
VIPom	VIP	subst:pl:dat:m1
VIPie	VIP	subst:sg:voc:m1
VIPie	VIP	subst:sg:loc:m1
VIPem	VIP	subst:sg:inst:m1
VIPa	VIP	subst:sg:gen:m1
VIPa	VIP	subst:sg:gen.acc:m1
VIPami	VIP	subst:pl:inst:m1
VIPach	VIP	subst:pl:loc:m1
VHSy	VHS	subst:pl:nom.acc.voc:m3
VHS	VHS	subst:sg.pl:nom.gen.dat.acc.inst.loc.voc:m3
VHS	VHS	subst:sg:nom.acc:m3
VHSu	VHS	subst:sg:gen:m3
VHSów	VHS	subst:pl:gen:m3
VHSowi	VHS	subst:sg:dat:m3
VHSom	VHS	subst:pl:dat:m3
VHSie	VHS	subst:sg:voc:m3
VHSie	VHS	subst:sg:loc:m3
VHSem	VHS	subst:sg:inst:m3
VHSami	VHS	subst:pl:inst:m3
VHSach	VHS	subst:pl:loc:m3
VHFy	VHF	subst:pl:nom.acc.voc:m3
VHF	VHF	subst:sg.pl:nom.gen.dat.acc.inst.loc.voc:m3
VHF	VHF	subst:sg:nom.acc:m3
VHFu	VHF	subst:sg:gen:m3
VHFów	VHF	subst:pl:gen:m3
VHFowi	VHF	subst:sg:dat:m3
VHFom	VHF	subst:pl:dat:m3
VHFie	VHF	subst:sg:voc:m3
VHFie	VHF	subst:sg:loc:m3
VHFem	VHF	subst:sg:inst:m3
VHFami	VHF	subst:pl:inst:m3
VHFach	VHF	subst:pl:loc:m3
VGA	VGA	subst:sg.pl:nom.gen.dat.acc.inst.loc.voc:f
VCRze	VCR	subst:sg:voc:m3
VCRze	VCR	subst:sg:loc:m3
VCRy	VCR	subst:pl:nom.acc.voc:m3
VCR	VCR	subst:sg:nom.acc:m3
VCRu	VCR	subst:sg:gen:m3
VCRów	VCR	subst:pl:gen:m3
VCRowi	VCR	subst:sg:dat:m3
VCRom	VCR	subst:pl:dat:m3
VCRem	VCR	subst:sg:inst:m3
VCRami	VCR	subst:pl:inst:m3
VCRach	VCR	subst:pl:loc:m3
VATy	VAT	subst:pl:nom.acc.voc:m3
VAT	VAT	subst:sg.pl:nom.gen.dat.acc.inst.loc.voc:m3
VAT	VAT	subst:sg:nom.acc:m3
VATu	VAT	subst:sg:gen:m3
VATów	VAT	subst:pl:gen:m3
VATowi	VAT	subst:sg:dat:m3
VATom	VAT	subst:pl:dat:m3
VATem	VAT	subst:sg:inst:m3
VATami	VAT	subst:pl:inst:m3
VATach	VAT	subst:pl:loc:m3
VAcie	VAT	subst:sg:voc:m3
Vacie	VAT	subst:sg:voc:m3
VAcie	VAT	subst:sg:loc:m3
Vacie	VAT	subst:sg:loc:m3
UZ	UZ	subst:sg:nom.acc:m3
UZety	UZ	subst:pl:nom.acc.voc:m3
UZetu	UZ	subst:sg:gen:m3
UZetów	UZ	subst:pl:gen:m3
UZetowi	UZ	subst:sg:dat:m3
UZetom	UZ	subst:pl:dat:m3
UZetem	UZ	subst:sg:inst:m3
UZetami	UZ	subst:pl:inst:m3
UZetach	UZ	subst:pl:loc:m3
UZecie	UZ	subst:sg:voc:m3
UZecie	UZ	subst:sg:loc:m3
UW	UW:s2	subst:sg.pl:nom.gen.dat.acc.inst.loc.voc:n:ncol
UW	UW:s2	subst:sg.pl:nom.gen.dat.acc.inst.loc.voc:m3
UW	UW:s1	subst:sg.pl:nom.gen.dat.acc.inst.loc.voc:n:ncol
UW	UW:s1	subst:sg.pl:nom.gen.dat.acc.inst.loc.voc:f
UWrze	UWr	subst:sg:voc:m3
UWrze	UWr	subst:sg:loc:m3
UWry	UWr	subst:pl:nom.acc.voc:m3
UWr	UWr	subst:sg:nom.acc:m3
UWru	UWr	subst:sg:gen:m3
UWrów	UWr	subst:pl:gen:m3
UWrowi	UWr	subst:sg:dat:m3
UWrom	UWr	subst:pl:dat:m3
UWrem	UWr	subst:sg:inst:m3
UWrami	UWr	subst:pl:inst:m3
UWrach	UWr	subst:pl:loc:m3
UWMy	UWM	subst:pl:nom.acc.voc:m3
UWM	UWM	subst:sg:nom.acc:m3
UWMu	UWM	subst:sg:gen:m3
UWMów	UWM	subst:pl:gen:m3
UWMowi	UWM	subst:sg:dat:m3
UWMom	UWM	subst:pl:dat:m3
UWMie	UWM	subst:sg:voc:m3
UWMie	UWM	subst:sg:loc:m3
UWMem	UWM	subst:sg:inst:m3
UWMami	UWM	subst:pl:inst:m3
UWMach	UWM	subst:pl:loc:m3
UwB	UwB	subst:sg.pl:nom.gen.dat.acc.inst.loc.voc:n:ncol
UwB	UwB	subst:sg.pl:nom.gen.dat.acc.inst.loc.voc:m3
UV	UV	subst:sg.pl:nom.gen.dat.acc.inst.loc.voc:m3
UTP	UTP	subst:sg.pl:nom.gen.dat.acc.inst.loc.voc:m3
UŚlu	UŚl	subst:sg:voc:m3
UŚlu	UŚl	subst:sg:loc:m3
UŚlu	UŚl	subst:sg:gen:m3
UŚl	UŚl	subst:sg:nom.acc:m3
UŚlowi	UŚl	subst:sg:dat:m3
UŚlom	UŚl	subst:pl:dat:m3
UŚli	UŚl	subst:pl:gen:m3
UŚle	UŚl	subst:pl:nom.acc.voc:m3
UŚlem	UŚl	subst:sg:inst:m3
UŚlami	UŚl	subst:pl:inst:m3
UŚlach	UŚl	subst:pl:loc:m3
UŚu	UŚ	subst:sg:voc:m3
UŚu	UŚ	subst:sg:loc:m3
UŚu	UŚ	subst:sg:gen:m3
UŚ	UŚ	subst:sg:nom.acc:m3
UŚów	UŚ	subst:pl:gen:m3
UŚowi	UŚ	subst:sg:dat:m3
UŚom	UŚ	subst:pl:dat:m3
UŚe	UŚ	subst:pl:nom.acc.voc:m3
UŚem	UŚ	subst:sg:inst:m3
UŚami	UŚ	subst:pl:inst:m3
UŚach	UŚ	subst:pl:loc:m3
USG	USG	subst:sg.pl:nom.gen.dat.acc.inst.loc.voc:n:ncol
USC	USC	subst:sg.pl:nom.gen.dat.acc.inst.loc.voc:n:ncol
USC	USC	subst:sg.pl:nom.gen.dat.acc.inst.loc.voc:m3
USB	USB	subst:sg.pl:nom.gen.dat.acc.inst.loc.voc:n:ncol
USA	USA	subst:pl:nom.gen.dat.acc.inst.loc.voc:n:pt
USA	USA	subst:pl:nom.gen.dat.acc.inst.loc.voc:n:pt
USy	US	subst:pl:nom.acc.voc:m3
USu	US	subst:sg:gen:m3
US	US	subst:sg:nom.acc:m3
USów	US	subst:pl:gen:m3
USowi	US	subst:sg:dat:m3
USom	US	subst:pl:dat:m3
USie	US	subst:sg:voc:m3
USie	US	subst:sg:loc:m3
USem	US	subst:sg:inst:m3
USami	US	subst:pl:inst:m3
USach	US	subst:pl:loc:m3
URzy	URz	subst:pl:nom.acc.voc:m3
URzu	URz	subst:sg:gen:m3
URz	URz	subst:sg:nom.acc:m3
URzów	URz	subst:pl:gen:m3
URzowi	URz	subst:sg:dat:m3
URzom	URz	subst:pl:dat:m3
URzety	URz	subst:pl:nom.acc.voc:m3
URzetu	URz	subst:sg:gen:m3
URzetów	URz	subst:pl:gen:m3
URzetowi	URz	subst:sg:dat:m3
URzetom	URz	subst:pl:dat:m3
URzetem	URz	subst:sg:inst:m3
URzetami	URz	subst:pl:inst:m3
URzetach	URz	subst:pl:loc:m3
URzem	URz	subst:sg:inst:m3
URzecie	URz	subst:sg:voc:m3
URzecie	URz	subst:sg:loc:m3
URzami	URz	subst:pl:inst:m3
URzach	URz	subst:pl:loc:m3
URMy	URM	subst:pl:nom.acc.voc:m3
URMu	URM	subst:sg:gen:m3
URM	URM	subst:sg:nom.acc:m3
URMów	URM	subst:pl:gen:m3
URMowi	URM	subst:sg:dat:m3
URMom	URM	subst:pl:dat:m3
URMie	URM	subst:sg:voc:m3
URMie	URM	subst:sg:loc:m3
URMem	URM	subst:sg:inst:m3
URMami	URM	subst:pl:inst:m3
URMach	URM	subst:pl:loc:m3
URLu	URL	subst:sg:voc:m3
URLu	URL	subst:sg:loc:m3
URLu	URL	subst:sg:gen:m3
URL	URL	subst:sg:nom.acc:m3
URLowi	URL	subst:sg:dat:m3
URLom	URL	subst:pl:dat:m3
URLi	URL	subst:pl:gen:m3
URLe	URL	subst:pl:nom.acc.voc:m3
URLem	URL	subst:sg:inst:m3
URLami	URL	subst:pl:inst:m3
URLach	URL	subst:pl:loc:m3
UPT	UPT	subst:sg.pl:nom.gen.dat.acc.inst.loc.voc:n:ncol
UPT	UPT	subst:sg.pl:nom.gen.dat.acc.inst.loc.voc:m3
UPSy	UPS	subst:pl:nom.acc.voc:m3
UPSu	UPS	subst:sg:gen:m3
UPS	UPS	subst:sg:nom.acc:m3
UPSów	UPS	subst:pl:gen:m3
UPSowi	UPS	subst:sg:dat:m3
UPSom	UPS	subst:pl:dat:m3
UPSie	UPS	subst:sg:voc:m3
UPSie	UPS	subst:sg:loc:m3
UPSem	UPS	subst:sg:inst:m3
UPSami	UPS	subst:pl:inst:m3
UPSach	UPS	subst:pl:loc:m3
UPRze	UPR	subst:sg:voc:m3
UPRze	UPR	subst:sg:loc:m3
UPRy	UPR	subst:pl:nom.acc.voc:m3
UPRu	UPR	subst:sg:gen:m3
UPR	UPR	subst:sg.pl:nom.gen.dat.acc.inst.loc.voc:f
UPR	UPR	subst:sg:nom.acc:m3
UPRów	UPR	subst:pl:gen:m3
UPRowi	UPR	subst:sg:dat:m3
UPRom	UPR	subst:pl:dat:m3
UPRem	UPR	subst:sg:inst:m3
UPRami	UPR	subst:pl:inst:m3
UPRach	UPR	subst:pl:loc:m3
UPI	UPI	subst:sg.pl:nom.gen.dat.acc.inst.loc.voc:n:ncol
UPI	UPI	subst:sg.pl:nom.gen.dat.acc.inst.loc.voc:m3
UPA	UPA	subst:sg.pl:nom.gen.dat.acc.inst.loc.voc:n:ncol
UPA	UPA	subst:sg.pl:nom.gen.dat.acc.inst.loc.voc:f
UP	UP	subst:sg.pl:nom.gen.dat.acc.inst.loc.voc:n:ncol
UP	UP	subst:sg.pl:nom.gen.dat.acc.inst.loc.voc:f
UOPy	UOP	subst:pl:nom.acc.voc:m3
UOPu	UOP	subst:sg:gen:m3
UOP	UOP	subst:sg.pl:nom.gen.dat.acc.inst.loc.voc:m3
UOP	UOP	subst:sg:nom.acc:m3
UOPów	UOP	subst:pl:gen:m3
UOPowi	UOP	subst:sg:dat:m3
UOPom	UOP	subst:pl:dat:m3
UOPie	UOP	subst:sg:voc:m3
UOPie	UOP	subst:sg:loc:m3
UOPem	UOP	subst:sg:inst:m3
UOPami	UOP	subst:pl:inst:m3
UOPach	UOP	subst:pl:loc:m3
UO	UO	subst:sg.pl:nom.gen.dat.acc.inst.loc.voc:n:ncol
UO	UO	subst:sg.pl:nom.gen.dat.acc.inst.loc.voc:m3
UNZy	UNZ	subst:pl:nom.acc.voc:m3
UNZu	UNZ	subst:sg:gen:m3
UNZ	UNZ	subst:sg:nom.acc:m3
UNZów	UNZ	subst:pl:gen:m3
UNZowi	UNZ	subst:sg:dat:m3
UNZom	UNZ	subst:pl:dat:m3
UNZety	UNZ	subst:pl:nom.acc.voc:m3
UNZetu	UNZ	subst:sg:gen:m3
UNZetów	UNZ	subst:pl:gen:m3
UNZetowi	UNZ	subst:sg:dat:m3
UNZetom	UNZ	subst:pl:dat:m3
UNZetem	UNZ	subst:sg:inst:m3
UNZetami	UNZ	subst:pl:inst:m3
UNZetach	UNZ	subst:pl:loc:m3
UNZem	UNZ	subst:sg:inst:m3
UNZecie	UNZ	subst:sg:voc:m3
UNZecie	UNZ	subst:sg:loc:m3
UNZami	UNZ	subst:pl:inst:m3
UNZach	UNZ	subst:pl:loc:m3
UNRRA	UNRRA	subst:sg.pl:nom.gen.dat.acc.inst.loc.voc:f
UNO	UNO	subst:sg.pl:nom.gen.dat.acc.inst.loc.voc:n:ncol
UNO	UNO	subst:sg.pl:nom.gen.dat.acc.inst.loc.voc:f
UNIXy	UNIX	subst:pl:nom.acc.voc:m2
UNIX	UNIX	subst:sg:nom:m2
UNIXów	UNIX	subst:pl:gen:m2
UNIXowi	UNIX	subst:sg:dat:m2
UNIXom	UNIX	subst:pl:dat:m2
UNIXie	UNIX	subst:sg:voc:m2
UNIXie	UNIX	subst:sg:loc:m2
UNIXem	UNIX	subst:sg:inst:m2
UNIXa	UNIX	subst:sg:gen:m2
UNIXa	UNIX	subst:sg:gen.acc:m2
UNIXami	UNIX	subst:pl:inst:m2
UNIXach	UNIX	subst:pl:loc:m2
UNICEFy	UNICEF	subst:pl:nom.acc.voc:m3
UNICEFu	UNICEF	subst:sg:gen:m3
UNICEF	UNICEF	subst:sg:nom.acc:m3
UNICEFów	UNICEF	subst:pl:gen:m3
UNICEFowi	UNICEF	subst:sg:dat:m3
UNICEFom	UNICEF	subst:pl:dat:m3
UNICEFie	UNICEF	subst:sg:voc:m3
UNICEFie	UNICEF	subst:sg:loc:m3
UNICEFem	UNICEF	subst:sg:inst:m3
UNICEFami	UNICEF	subst:pl:inst:m3
UNICEFach	UNICEF	subst:pl:loc:m3
UNESCO	UNESCO	subst:sg.pl:nom.gen.dat.acc.inst.loc.voc:n:ncol
UNESCO	UNESCO	subst:sg.pl:nom.gen.dat.acc.inst.loc.voc:f
UN	UN	subst:sg.pl:nom.gen.dat.acc.inst.loc.voc:m3
UN	UN	subst:pl:nom.gen.dat.acc.inst.loc.voc:n:pt
UMTSy	UMTS	subst:pl:nom.acc.voc:m3
UMTSu	UMTS	subst:sg:gen:m3
UMTS	UMTS	subst:sg:nom.acc:m3
UMTSów	UMTS	subst:pl:gen:m3
UMTSowi	UMTS	subst:sg:dat:m3
UMTSom	UMTS	subst:pl:dat:m3
UMTSie	UMTS	subst:sg:voc:m3
UMTSie	UMTS	subst:sg:loc:m3
UMTSem	UMTS	subst:sg:inst:m3
UMTSami	UMTS	subst:pl:inst:m3
UMTSach	UMTS	subst:pl:loc:m3
UMK	UMK	subst:sg.pl:nom.gen.dat.acc.inst.loc.voc:n:ncol
UMK	UMK	subst:sg.pl:nom.gen.dat.acc.inst.loc.voc:m3
UMCSy	UMCS	subst:pl:nom.acc.voc:m3
UMCSu	UMCS	subst:sg:gen:m3
UMCS	UMCS	subst:sg:nom.acc:m3
UMCSów	UMCS	subst:pl:gen:m3
UMCSowi	UMCS	subst:sg:dat:m3
UMCSom	UMCS	subst:pl:dat:m3
UMCSie	UMCS	subst:sg:voc:m3
UMCSie	UMCS	subst:sg:loc:m3
UMCSem	UMCS	subst:sg:inst:m3
UMCSami	UMCS	subst:pl:inst:m3
UMCSach	UMCS	subst:pl:loc:m3
UMy	UM	subst:pl:nom.acc.voc:m3
UMu	UM	subst:sg:gen:m3
UM	UM	subst:sg:nom.acc:m3
UMów	UM	subst:pl:gen:m3
UMowi	UM	subst:sg:dat:m3
UMom	UM	subst:pl:dat:m3
UMie	UM	subst:sg:voc:m3
UMie	UM	subst:sg:loc:m3
UMem	UM	subst:sg:inst:m3
UMami	UM	subst:pl:inst:m3
UMach	UM	subst:pl:loc:m3
UŁ	UŁ	subst:sg.pl:nom.gen.dat.acc.inst.loc.voc:n:ncol
UŁ	UŁ	subst:sg.pl:nom.gen.dat.acc.inst.loc.voc:m3
UKW	UKW	subst:sg.pl:nom.gen.dat.acc.inst.loc.voc:m3
UKSW	UKSW	subst:sg.pl:nom.gen.dat.acc.inst.loc.voc:n:ncol
UKSW	UKSW	subst:sg.pl:nom.gen.dat.acc.inst.loc.voc:m3
UKFy	UKF	subst:pl:nom.acc.voc:m3
UKFu	UKF	subst:sg:gen:m3
UKF	UKF	subst:sg:nom.acc:m3
UKFów	UKF	subst:pl:gen:m3
UKFowi	UKF	subst:sg:dat:m3
UKFom	UKF	subst:pl:dat:m3
UKFie	UKF	subst:sg:voc:m3
UKFie	UKF	subst:sg:loc:m3
UKFem	UKF	subst:sg:inst:m3
UKFami	UKF	subst:pl:inst:m3
UKFach	UKF	subst:pl:loc:m3
UJ	UJ	subst:sg.pl:nom.gen.dat.acc.inst.loc.voc:m3
UJ	UJ	subst:sg:nom.acc:m3
UJoty	UJ	subst:pl:nom.acc.voc:m3
UJotu	UJ	subst:sg:gen:m3
UJotów	UJ	subst:pl:gen:m3
UJotowi	UJ	subst:sg:dat:m3
UJotom	UJ	subst:pl:dat:m3
UJotem	UJ	subst:sg:inst:m3
UJotami	UJ	subst:pl:inst:m3
UJotach	UJ	subst:pl:loc:m3
UJocie	UJ	subst:sg:voc:m3
UJocie	UJ	subst:sg:loc:m3
UHT	UHT	subst:sg.pl:nom.gen.dat.acc.inst.loc.voc:n:ncol
UG	UG	subst:sg.pl:nom.gen.dat.acc.inst.loc.voc:n:ncol
UG	UG	subst:sg.pl:nom.gen.dat.acc.inst.loc.voc:m3
UFO	UFO	subst:sg.pl:nom.gen.dat.acc.inst.loc.voc:n:ncol
UEFy	UEFA	subst:sg:gen:f
UEFy	UEFA	subst:pl:nom.acc.voc:f
UEF	UEFA	subst:pl:gen:f
UEFo	UEFA	subst:sg:voc:f
UEFom	UEFA	subst:pl:dat:f
UEFie	UEFA	subst:sg:dat.loc:f
UEFę	UEFA	subst:sg:acc:f
UEFą	UEFA	subst:sg:inst:f
UEFA	UEFA	subst:sg:nom:f
UEFami	UEFA	subst:pl:inst:f
UEFach	UEFA	subst:pl:loc:f
UE	UE	subst:sg.pl:nom.gen.dat.acc.inst.loc.voc:n:ncol
UE	UE	subst:sg.pl:nom.gen.dat.acc.inst.loc.voc:f
UC	UC	subst:sg.pl:nom.gen.dat.acc.inst.loc.voc:n:ncol
UC	UC	subst:sg.pl:nom.gen.dat.acc.inst.loc.voc:m3
UB	UB	subst:sg.pl:nom.gen.dat.acc.inst.loc.voc:n:ncol
UB	UB	subst:sg.pl:nom.gen.dat.acc.inst.loc.voc:m3
UAMy	UAM	subst:pl:nom.acc.voc:m3
UAMu	UAM	subst:sg:gen:m3
UAM	UAM	subst:sg:nom.acc:m3
UAMów	UAM	subst:pl:gen:m3
UAMowi	UAM	subst:sg:dat:m3
UAMom	UAM	subst:pl:dat:m3
UAMie	UAM	subst:sg:voc:m3
UAMie	UAM	subst:sg:loc:m3
UAMem	UAM	subst:sg:inst:m3
UAMami	UAM	subst:pl:inst:m3
UAMach	UAM	subst:pl:loc:m3
TZSP	TZSP	subst:sg.pl:nom.gen.dat.acc.inst.loc.voc:n:ncol
TWP	TWP	subst:sg.pl:nom.gen.dat.acc.inst.loc.voc:n:ncol
TWA	TWA	subst:sg.pl:nom.gen.dat.acc.inst.loc.voc:m3
TWA	TWA	subst:sg.pl:nom.gen.dat.acc.inst.loc.voc:f
TW	TW	subst:sg.pl:nom.gen.dat.acc.inst.loc.voc:n:ncol
TW	TW	subst:sg.pl:nom.gen.dat.acc.inst.loc.voc:m3
TVP	TVP	subst:sg.pl:nom.gen.dat.acc.inst.loc.voc:f
TVN	TVN	subst:sg.pl:nom.gen.dat.acc.inst.loc.voc:m3
TVN	TVN	subst:sg.pl:nom.gen.dat.acc.inst.loc.voc:f
TV	TV	subst:sg.pl:nom.gen.dat.acc.inst.loc.voc:f
tv	tv	subst:sg.pl:nom.gen.dat.acc.inst.loc.voc:f
TURze	TUR	subst:sg:voc:m3
TURze	TUR	subst:sg:loc:m3
TURy	TUR	subst:pl:nom.acc.voc:m3
TURu	TUR	subst:sg:gen:m3
TUR	TUR	subst:sg.pl:nom.gen.dat.acc.inst.loc.voc:n:ncol
TUR	TUR	subst:sg:nom.acc:m3
TURów	TUR	subst:pl:gen:m3
TURowi	TUR	subst:sg:dat:m3
TURom	TUR	subst:pl:dat:m3
TURem	TUR	subst:sg:inst:m3
TURami	TUR	subst:pl:inst:m3
TURach	TUR	subst:pl:loc:m3
TSy	TS	subst:pl:nom.acc.voc:m3
TSu	TS	subst:sg:gen:m3
TS	TS	subst:sg:nom.acc:m3
TSów	TS	subst:pl:gen:m3
TSowi	TS	subst:sg:dat:m3
TSom	TS	subst:pl:dat:m3
TSie	TS	subst:sg:voc:m3
TSie	TS	subst:sg:loc:m3
TSem	TS	subst:sg:inst:m3
TSami	TS	subst:pl:inst:m3
TSach	TS	subst:pl:loc:m3
TP	TP:s2	subst:sg.pl:nom.gen.dat.acc.inst.loc.voc:n:ncol
TP	TP:s2	subst:sg.pl:nom.gen.dat.acc.inst.loc.voc:f
TP	TP:s1	subst:sg.pl:nom.gen.dat.acc.inst.loc.voc:n:ncol
TPPRze	TPPR	subst:sg:voc:m3
TPPRze	TPPR	subst:sg:loc:m3
TPPRy	TPPR	subst:pl:nom.acc.voc:m3
TPPRu	TPPR	subst:sg:gen:m3
TPPR	TPPR	subst:sg.pl:nom.gen.dat.acc.inst.loc.voc:n:ncol
TPPR	TPPR	subst:sg:nom.acc:m3
TPPRów	TPPR	subst:pl:gen:m3
TPPRowi	TPPR	subst:sg:dat:m3
TPPRom	TPPR	subst:pl:dat:m3
TPPRem	TPPR	subst:sg:inst:m3
TPPRami	TPPR	subst:pl:inst:m3
TPPRach	TPPR	subst:pl:loc:m3
TPNy	TPN	subst:pl:nom.acc.voc:m3
TPNu	TPN	subst:sg:gen:m3
TPN	TPN	subst:sg:nom.acc:m3
TPNów	TPN	subst:pl:gen:m3
TPNowi	TPN	subst:sg:dat:m3
TPNom	TPN	subst:pl:dat:m3
TPNie	TPN	subst:sg:voc:m3
TPNie	TPN	subst:sg:loc:m3
TPNem	TPN	subst:sg:inst:m3
TPNami	TPN	subst:pl:inst:m3
TPNach	TPN	subst:pl:loc:m3
TPI	TPI	subst:sg.pl:nom.gen.dat.acc.inst.loc.voc:n:ncol
TPD	TPD	subst:sg.pl:nom.gen.dat.acc.inst.loc.voc:n:ncol
TOZy	TOZ	subst:pl:nom.acc.voc:m3
TOZu	TOZ	subst:sg:gen:m3
TOZ	TOZ	subst:sg.pl:nom.gen.dat.acc.inst.loc.voc:n:ncol
TOZ	TOZ	subst:sg:nom.acc:m3
TOZów	TOZ	subst:pl:gen:m3
TOZowi	TOZ	subst:sg:dat:m3
TOZom	TOZ	subst:pl:dat:m3
TOZie	TOZ	subst:sg:voc:m3
TOZie	TOZ	subst:sg:loc:m3
TOZem	TOZ	subst:sg:inst:m3
TOZami	TOZ	subst:pl:inst:m3
TOZach	TOZ	subst:pl:loc:m3
TOPRze	TOPR	subst:sg:voc:m3
TOPRze	TOPR	subst:sg:loc:m3
TOPRy	TOPR	subst:pl:nom.acc.voc:m3
TOPRu	TOPR	subst:sg:gen:m3
TOPR	TOPR	subst:sg.pl:nom.gen.dat.acc.inst.loc.voc:n:ncol
TOPR	TOPR	subst:sg:nom.acc:m3
TOPRów	TOPR	subst:pl:gen:m3
TOPRowi	TOPR	subst:sg:dat:m3
TOPRom	TOPR	subst:pl:dat:m3
TOPRem	TOPR	subst:sg:inst:m3
TOPRami	TOPR	subst:pl:inst:m3
TOPRach	TOPR	subst:pl:loc:m3
TNT	TNT	subst:sg.pl:nom.gen.dat.acc.inst.loc.voc:n:ncol
TKKFy	TKKF	subst:pl:nom.acc.voc:m3
TKKFu	TKKF	subst:sg:gen:m3
TKKF	TKKF	subst:sg.pl:nom.gen.dat.acc.inst.loc.voc:n:ncol
TKKF	TKKF	subst:sg:nom.acc:m3
TKKFów	TKKF	subst:pl:gen:m3
TKKFowi	TKKF	subst:sg:dat:m3
TKKFom	TKKF	subst:pl:dat:m3
TKKFie	TKKF	subst:sg:voc:m3
TKKFie	TKKF	subst:sg:loc:m3
TKKFem	TKKF	subst:sg:inst:m3
TKKFami	TKKF	subst:pl:inst:m3
TKKFach	TKKF	subst:pl:loc:m3
TKJ	TKJ	subst:sg.pl:nom.gen.dat.acc.inst.loc.voc:n:ncol
TKJ	TKJ	subst:sg:nom.acc:m3
TKJoty	TKJ	subst:pl:nom.acc.voc:m3
TKJotu	TKJ	subst:sg:gen:m3
TKJotów	TKJ	subst:pl:gen:m3
TKJotowi	TKJ	subst:sg:dat:m3
TKJotom	TKJ	subst:pl:dat:m3
TKJotem	TKJ	subst:sg:inst:m3
TKJotami	TKJ	subst:pl:inst:m3
TKJotach	TKJ	subst:pl:loc:m3
TKJocie	TKJ	subst:sg:voc:m3
TKJocie	TKJ	subst:sg:loc:m3
TK	TK	subst:sg.pl:nom.gen.dat.acc.inst.loc.voc:m3
TIRze	TIR	subst:sg:voc:m2
TIRze	TIR	subst:sg:loc:m2
TIRy	TIR	subst:pl:nom.acc.voc:m2
TIR	TIR	subst:sg:nom:m2
TIRów	TIR	subst:pl:gen:m2
TIRowi	TIR	subst:sg:dat:m2
TIRom	TIR	subst:pl:dat:m2
TIRem	TIR	subst:sg:inst:m2
TIRa	TIR	subst:sg:gen:m2
TIRa	TIR	subst:sg:gen.acc:m2
TIRami	TIR	subst:pl:inst:m2
TIRach	TIR	subst:pl:loc:m2
TGV	TGV	subst:sg.pl:nom.gen.dat.acc.inst.loc.voc:n:ncol
TGV	TGV	subst:sg.pl:nom.gen.dat.acc.inst.loc.voc:m3
TABy	TAB	subst:pl:nom.acc.voc:m3
TABu	TAB	subst:sg:gen:m3
TAB	TAB	subst:sg.pl:nom.gen.dat.acc.inst.loc.voc:n:ncol
TAB	TAB	subst:sg:nom.acc:m3
TABów	TAB	subst:pl:gen:m3
TABowi	TAB	subst:sg:dat:m3
TABom	TAB	subst:pl:dat:m3
TABie	TAB	subst:sg:voc:m3
TABie	TAB	subst:sg:loc:m3
TABem	TAB	subst:sg:inst:m3
TABami	TAB	subst:pl:inst:m3
TABach	TAB	subst:pl:loc:m3
ŚPNy	ŚPN	subst:pl:nom.acc.voc:m3
ŚPNu	ŚPN	subst:sg:gen:m3
ŚPN	ŚPN	subst:sg:nom.acc:m3
ŚPNów	ŚPN	subst:pl:gen:m3
ŚPNowi	ŚPN	subst:sg:dat:m3
ŚPNom	ŚPN	subst:pl:dat:m3
ŚPNie	ŚPN	subst:sg:voc:m3
ŚPNie	ŚPN	subst:sg:loc:m3
ŚPNem	ŚPN	subst:sg:inst:m3
ŚPNami	ŚPN	subst:pl:inst:m3
ŚPNach	ŚPN	subst:pl:loc:m3
ŚAMy	ŚAM	subst:pl:nom.acc.voc:m3
ŚAMu	ŚAM	subst:sg:gen:m3
ŚAM	ŚAM	subst:sg.pl:nom.gen.dat.acc.inst.loc.voc:f
ŚAM	ŚAM	subst:sg:nom.acc:m3
ŚAMów	ŚAM	subst:pl:gen:m3
ŚAMowi	ŚAM	subst:sg:dat:m3
ŚAMom	ŚAM	subst:pl:dat:m3
ŚAMie	ŚAM	subst:sg:voc:m3
ŚAMie	ŚAM	subst:sg:loc:m3
ŚAMem	ŚAM	subst:sg:inst:m3
ŚAMami	ŚAM	subst:pl:inst:m3
ŚAMach	ŚAM	subst:pl:loc:m3
SW	SW	subst:sg.pl:nom.gen.dat.acc.inst.loc.voc:m3
SUDANAIRze	SUDANAIR	subst:sg:voc:m3
SUDANAIRze	SUDANAIR	subst:sg:loc:m3
SUDANAIRy	SUDANAIR	subst:pl:nom.acc.voc:m3
SUDANAIRu	SUDANAIR	subst:sg:gen:m3
SUDANAIR	SUDANAIR	subst:sg:nom.acc:m3
SUDANAIRów	SUDANAIR	subst:pl:gen:m3
SUDANAIRowi	SUDANAIR	subst:sg:dat:m3
SUDANAIRom	SUDANAIR	subst:pl:dat:m3
SUDANAIRem	SUDANAIR	subst:sg:inst:m3
SUDANAIRami	SUDANAIR	subst:pl:inst:m3
SUDANAIRach	SUDANAIR	subst:pl:loc:m3
STARze	STAR	subst:sg:voc:m2
STARze	STAR	subst:sg:loc:m2
STARy	STAR	subst:pl:nom.acc.voc:m2
STAR	STAR	subst:sg:nom:m2
STARów	STAR	subst:pl:gen:m2
STARowi	STAR	subst:sg:dat:m2
STARom	STAR	subst:pl:dat:m2
STARem	STAR	subst:sg:inst:m2
STARa	STAR	subst:sg:gen:m2
STARa	STAR	subst:sg:gen.acc:m2
STARami	STAR	subst:pl:inst:m2
STARach	STAR	subst:pl:loc:m2
SS	SS:s2	subst:sg.pl:nom.gen.dat.acc.inst.loc.voc:f
SS	SS:s1	subst:sg.pl:nom.gen.dat.acc.inst.loc.voc:n:ncol
SS	SS:s1	subst:sg.pl:nom.gen.dat.acc.inst.loc.voc:f
SPP	SPP:s2	subst:sg.pl:nom.gen.dat.acc.inst.loc.voc:m3
SPP	SPP:s1	subst:sg.pl:nom.gen.dat.acc.inst.loc.voc:n:ncol
SPNy	SPN	subst:pl:nom.acc.voc:m3
SPNu	SPN	subst:sg:gen:m3
SPN	SPN	subst:sg:nom.acc:m3
SPNów	SPN	subst:pl:gen:m3
SPNowi	SPN	subst:sg:dat:m3
SPNom	SPN	subst:pl:dat:m3
SPNie	SPN	subst:sg:voc:m3
SPNie	SPN	subst:sg:loc:m3
SPNem	SPN	subst:sg:inst:m3
SPNami	SPN	subst:pl:inst:m3
SPNach	SPN	subst:pl:loc:m3
SPFy	SPF	subst:pl:nom.acc.voc:m3
SPFu	SPF	subst:sg:gen:m3
SPF	SPF	subst:sg:nom.acc:m3
SPFów	SPF	subst:pl:gen:m3
SPFowi	SPF	subst:sg:dat:m3
SPFom	SPF	subst:pl:dat:m3
SPFie	SPF	subst:sg:voc:m3
SPFie	SPF	subst:sg:loc:m3
SPFem	SPF	subst:sg:inst:m3
SPFami	SPF	subst:pl:inst:m3
SPFach	SPF	subst:pl:loc:m3
SPD	SPD:s2	subst:sg.pl:nom.gen.dat.acc.inst.loc.voc:n:ncol
SPD	SPD:s1	subst:sg.pl:nom.gen.dat.acc.inst.loc.voc:n:ncol
SPD	SPD:s1	subst:sg.pl:nom.gen.dat.acc.inst.loc.voc:f
SPATiFy	SPATiF	subst:pl:nom.acc.voc:m3
SPATiFu	SPATiF	subst:sg:gen:m3
SPATiF	SPATiF	subst:sg.pl:nom.gen.dat.acc.inst.loc.voc:n:ncol
SPATiF	SPATiF	subst:sg:nom.acc:m3
SPATiFów	SPATiF	subst:pl:gen:m3
SPATiFowi	SPATiF	subst:sg:dat:m3
SPATiFom	SPATiF	subst:pl:dat:m3
SPATiFie	SPATiF	subst:sg:voc:m3
SPATiFie	SPATiF	subst:sg:loc:m3
SPATiFem	SPATiF	subst:sg:inst:m3
SPATiFami	SPATiF	subst:pl:inst:m3
SPATiFach	SPATiF	subst:pl:loc:m3
SP	SP	subst:sg.pl:nom.gen.dat.acc.inst.loc.voc:n:ncol
SP	SP	subst:sg.pl:nom.gen.dat.acc.inst.loc.voc:f
SOS	SOS	subst:sg.pl:nom.gen.dat.acc.inst.loc.voc:n:ncol
SOS	SOS	subst:sg.pl:nom.gen.dat.acc.inst.loc.voc:m3
SOKu	SOK	subst:sg:voc:m3
SOKu	SOK	subst:sg:loc:m3
SOKu	SOK	subst:sg:gen:m3
SOK	SOK	subst:sg.pl:nom.gen.dat.acc.inst.loc.voc:f
SOK	SOK	subst:sg:nom.acc:m3
SOKów	SOK	subst:pl:gen:m3
SOKowi	SOK	subst:sg:dat:m3
SOKom	SOK	subst:pl:dat:m3
SOKi	SOK	subst:pl:nom.acc.voc:m3
SOKiem	SOK	subst:sg:inst:m3
SOKami	SOK	subst:pl:inst:m3
SOKach	SOK	subst:pl:loc:m3
SO	SO	subst:sg.pl:nom.gen.dat.acc.inst.loc.voc:n:ncol
SO	SO	subst:sg.pl:nom.gen.dat.acc.inst.loc.voc:m3
SMy	SM:s2	subst:pl:nom.acc.voc:m3
SMu	SM:s2	subst:sg:gen:m3
SM	SM:s2	subst:sg.pl:nom.gen.dat.acc.inst.loc.voc:f
SM	SM:s2	subst:sg:nom.acc:m3
SMów	SM:s2	subst:pl:gen:m3
SMowi	SM:s2	subst:sg:dat:m3
SMom	SM:s2	subst:pl:dat:m3
SMie	SM:s2	subst:sg:voc:m3
SMie	SM:s2	subst:sg:loc:m3
SMem	SM:s2	subst:sg:inst:m3
SMami	SM:s2	subst:pl:inst:m3
SMach	SM:s2	subst:pl:loc:m3
SM	SM:s1	subst:sg.pl:nom.gen.dat.acc.inst.loc.voc:f
SMSy	SMS	subst:pl:nom.acc.voc:m3
SMSy	SMS	subst:pl:nom.acc.voc:m2
SMSu	SMS	subst:sg:gen:m3
SMS	SMS	subst:sg:nom:m2
SMS	SMS	subst:sg:nom.acc:m3
SMSów	SMS	subst:pl:gen:m3
SMSów	SMS	subst:pl:gen:m2
SMSowi	SMS	subst:sg:dat:m3
SMSowi	SMS	subst:sg:dat:m2
SMSom	SMS	subst:pl:dat:m3
SMSom	SMS	subst:pl:dat:m2
SMSie	SMS	subst:sg:voc:m3
SMSie	SMS	subst:sg:voc:m2
SMSie	SMS	subst:sg:loc:m3
SMSie	SMS	subst:sg:loc:m2
SMSem	SMS	subst:sg:inst:m3
SMSem	SMS	subst:sg:inst:m2
SMSa	SMS	subst:sg:gen:m2
SMSa	SMS	subst:sg:gen.acc:m2
SMSami	SMS	subst:pl:inst:m3
SMSami	SMS	subst:pl:inst:m2
SMSach	SMS	subst:pl:loc:m3
SMSach	SMS	subst:pl:loc:m2
smsy	sms	subst:pl:nom.acc.voc:m3
smsy	sms	subst:pl:nom.acc.voc:m3
smsy	sms	subst:pl:nom.acc.voc:m2
smsy	sms	subst:pl:nom.acc.voc:m2
smsu	sms	subst:sg:gen:m3
smsu	sms	subst:sg:gen:m3
sms	sms	subst:sg:nom:m2
sms	sms	subst:sg:nom.acc:m3
smsów	sms	subst:pl:gen:m3
smsów	sms	subst:pl:gen:m3
smsów	sms	subst:pl:gen:m2
smsów	sms	subst:pl:gen:m2
smsowi	sms	subst:sg:dat:m3
smsowi	sms	subst:sg:dat:m3
smsowi	sms	subst:sg:dat:m2
smsowi	sms	subst:sg:dat:m2
smsom	sms	subst:pl:dat:m3
smsom	sms	subst:pl:dat:m3
smsom	sms	subst:pl:dat:m2
smsom	sms	subst:pl:dat:m2
smsie	sms	subst:sg:voc:m3
smsie	sms	subst:sg:voc:m3
smsie	sms	subst:sg:voc:m2
smsie	sms	subst:sg:voc:m2
smsie	sms	subst:sg:loc:m3
smsie	sms	subst:sg:loc:m3
smsie	sms	subst:sg:loc:m2
smsie	sms	subst:sg:loc:m2
smsem	sms	subst:sg:inst:m3
smsem	sms	subst:sg:inst:m3
smsem	sms	subst:sg:inst:m2
smsem	sms	subst:sg:inst:m2
smsa	sms	subst:sg:gen:m2
smsa	sms	subst:sg:gen:m2
smsa	sms	subst:sg:gen.acc:m2
smsa	sms	subst:sg:gen.acc:m2
smsami	sms	subst:pl:inst:m3
smsami	sms	subst:pl:inst:m3
smsami	sms	subst:pl:inst:m2
smsami	sms	subst:pl:inst:m2
smsach	sms	subst:pl:loc:m3
smsach	sms	subst:pl:loc:m3
smsach	sms	subst:pl:loc:m2
smsach	sms	subst:pl:loc:m2
SMJP	SMJP	subst:sg.pl:nom.gen.dat.acc.inst.loc.voc:n:ncol
SLO	SLO	subst:sg.pl:nom.gen.dat.acc.inst.loc.voc:n:ncol
SLD	SLD	subst:sg.pl:nom.gen.dat.acc.inst.loc.voc:n:ncol
SLD	SLD	subst:sg.pl:nom.gen.dat.acc.inst.loc.voc:m3
SKSy	SKS	subst:pl:nom.acc.voc:m3
SKSu	SKS	subst:sg:gen:m3
SKS	SKS	subst:sg:nom.acc:m3
SKSów	SKS	subst:pl:gen:m3
SKSowi	SKS	subst:sg:dat:m3
SKSom	SKS	subst:pl:dat:m3
SKSie	SKS	subst:sg:voc:m3
SKSie	SKS	subst:sg:loc:m3
SKSem	SKS	subst:sg:inst:m3
SKSami	SKS	subst:pl:inst:m3
SKSach	SKS	subst:pl:loc:m3
SKOKu	SKOK	subst:sg:voc:m3
SKOKu	SKOK	subst:sg:loc:m3
SKOKu	SKOK	subst:sg:gen:m3
SKOK	SKOK	subst:sg.pl:nom.gen.dat.acc.inst.loc.voc:f
SKOK	SKOK	subst:sg:nom.acc:m3
SKOKów	SKOK	subst:pl:gen:m3
SKOKowi	SKOK	subst:sg:dat:m3
SKOKom	SKOK	subst:pl:dat:m3
SKOKi	SKOK	subst:pl:nom.acc.voc:m3
SKOKiem	SKOK	subst:sg:inst:m3
SKOKami	SKOK	subst:pl:inst:m3
SKOKach	SKOK	subst:pl:loc:m3
SIMMy	SIMM	subst:pl:nom.acc.voc:m3
SIMMu	SIMM	subst:sg:gen:m3
SIMM	SIMM	subst:sg:nom.acc:m3
SIMMów	SIMM	subst:pl:gen:m3
SIMMowi	SIMM	subst:sg:dat:m3
SIMMom	SIMM	subst:pl:dat:m3
SIMMie	SIMM	subst:sg:voc:m3
SIMMie	SIMM	subst:sg:loc:m3
SIMMem	SIMM	subst:sg:inst:m3
SIMMa	SIMM	subst:sg:gen:m3
SIMMami	SIMM	subst:pl:inst:m3
SIMMach	SIMM	subst:pl:loc:m3
SIMy	SIM	subst:pl:nom.acc.voc:m3
SIMu	SIM	subst:sg:gen:m3
SIM	SIM	subst:sg:nom.acc:m3
SIMów	SIM	subst:pl:gen:m3
SIMowi	SIM	subst:sg:dat:m3
SIMom	SIM	subst:pl:dat:m3
SIMie	SIM	subst:sg:voc:m3
SIMie	SIM	subst:sg:loc:m3
SIMem	SIM	subst:sg:inst:m3
SIMami	SIM	subst:pl:inst:m3
SIMach	SIM	subst:pl:loc:m3
SI	SI	subst:sg.pl:nom.gen.dat.acc.inst.loc.voc:n:ncol
SGPiSy	SGPiS	subst:pl:nom.acc.voc:m3
SGPiSu	SGPiS	subst:sg:gen:m3
SGPiS	SGPiS	subst:sg.pl:nom.gen.dat.acc.inst.loc.voc:f
SGPiS	SGPiS	subst:sg:nom.acc:m3
SGPiSów	SGPiS	subst:pl:gen:m3
SGPiSowi	SGPiS	subst:sg:dat:m3
SGPiSom	SGPiS	subst:pl:dat:m3
SGPiSie	SGPiS	subst:sg:voc:m3
SGPiSie	SGPiS	subst:sg:loc:m3
SGPiSem	SGPiS	subst:sg:inst:m3
SGPiSami	SGPiS	subst:pl:inst:m3
SGPiSach	SGPiS	subst:pl:loc:m3
SGMLu	SGML	subst:sg:voc:m3
SGMLu	SGML	subst:sg:voc:m2
SGMLu	SGML	subst:sg:loc:m3
SGMLu	SGML	subst:sg:loc:m2
SGMLu	SGML	subst:sg:gen:m3
SGML	SGML	subst:sg:nom:m2
SGML	SGML	subst:sg:nom.acc:m3
SGMLów	SGML	subst:pl:gen:m2
SGMLowi	SGML	subst:sg:dat:m3
SGMLowi	SGML	subst:sg:dat:m2
SGMLom	SGML	subst:pl:dat:m3
SGMLom	SGML	subst:pl:dat:m2
SGMLi	SGML	subst:pl:gen:m3
SGMLe	SGML	subst:pl:nom.acc.voc:m3
SGMLe	SGML	subst:pl:nom.acc.voc:m2
SGMLem	SGML	subst:sg:inst:m3
SGMLem	SGML	subst:sg:inst:m2
SGMLa	SGML	subst:sg:gen:m2
SGMLa	SGML	subst:sg:gen.acc:m2
SGMLami	SGML	subst:pl:inst:m3
SGMLami	SGML	subst:pl:inst:m2
SGMLach	SGML	subst:pl:loc:m3
SGMLach	SGML	subst:pl:loc:m2
SGH	SGH	subst:sg.pl:nom.gen.dat.acc.inst.loc.voc:n:ncol
SGH	SGH	subst:sg.pl:nom.gen.dat.acc.inst.loc.voc:f
SGGWAR	SGGWAR	subst:sg.pl:nom.gen.dat.acc.inst.loc.voc:n:ncol
SGGWAR	SGGWAR	subst:sg.pl:nom.gen.dat.acc.inst.loc.voc:f
SGGW	SGGW	subst:sg.pl:nom.gen.dat.acc.inst.loc.voc:n:ncol
SGGW	SGGW	subst:sg.pl:nom.gen.dat.acc.inst.loc.voc:f
SG	SG	subst:sg.pl:nom.gen.dat.acc.inst.loc.voc:n:ncol
SG	SG	subst:sg.pl:nom.gen.dat.acc.inst.loc.voc:f
SF	SF	subst:sg.pl:nom.gen.dat.acc.inst.loc.voc:n:ncol
SECAMy	SECAM	subst:pl:nom.acc.voc:m3
SECAMu	SECAM	subst:sg:gen:m3
SECAM	SECAM	subst:sg:nom.acc:m3
SECAMów	SECAM	subst:pl:gen:m3
SECAMowi	SECAM	subst:sg:dat:m3
SECAMom	SECAM	subst:pl:dat:m3
SECAMie	SECAM	subst:sg:voc:m3
SECAMie	SECAM	subst:sg:loc:m3
SECAMem	SECAM	subst:sg:inst:m3
SECAMami	SECAM	subst:pl:inst:m3
SECAMach	SECAM	subst:pl:loc:m3
SEATO	SEATO	subst:sg.pl:nom.gen.dat.acc.inst.loc.voc:n:ncol
SEATO	SEATO	subst:sg.pl:nom.gen.dat.acc.inst.loc.voc:f
SdRP	SdRP	subst:sg.pl:nom.gen.dat.acc.inst.loc.voc:n:ncol
SdRP	SdRP	subst:sg.pl:nom.gen.dat.acc.inst.loc.voc:f
SDP	SDP	subst:sg.pl:nom.gen.dat.acc.inst.loc.voc:n:ncol
SDKPiLu	SDKPiL	subst:sg:voc:m3
SDKPiLu	SDKPiL	subst:sg:loc:m3
SDKPiLu	SDKPiL	subst:sg:gen:m3
SDKPiL	SDKPiL	subst:sg.pl:nom.gen.dat.acc.inst.loc.voc:f
SDKPiL	SDKPiL	subst:sg:nom.acc:m3
SDKPiLowi	SDKPiL	subst:sg:dat:m3
SDKPiLom	SDKPiL	subst:pl:dat:m3
SDKPiLi	SDKPiL	subst:pl:gen:m3
SDKPiLe	SDKPiL	subst:pl:nom.acc.voc:m3
SDKPiLem	SDKPiL	subst:sg:inst:m3
SDKPiLami	SDKPiL	subst:pl:inst:m3
SDKPiLach	SDKPiL	subst:pl:loc:m3
SDK	SDK	subst:sg.pl:nom.gen.dat.acc.inst.loc.voc:n:ncol
SDK	SDK	subst:sg.pl:nom.gen.dat.acc.inst.loc.voc:m3
SD	SD	subst:sg.pl:nom.gen.dat.acc.inst.loc.voc:n:ncol
scsy	scs	subst:pl:nom.acc.voc:m3
scsu	scs	subst:sg:gen:m3
scs	scs	subst:sg:nom.acc:m3
scsów	scs	subst:pl:gen:m3
scsowi	scs	subst:sg:dat:m3
scsom	scs	subst:pl:dat:m3
scsie	scs	subst:sg:voc:m3
scsie	scs	subst:sg:loc:m3
scsem	scs	subst:sg:inst:m3
scsami	scs	subst:pl:inst:m3
scsach	scs	subst:pl:loc:m3
SCMSy	SCMS	subst:pl:nom.acc.voc:m3
SCMSu	SCMS	subst:sg:gen:m3
SCMS	SCMS	subst:sg:nom.acc:m3
SCMSów	SCMS	subst:pl:gen:m3
SCMSowi	SCMS	subst:sg:dat:m3
SCMSom	SCMS	subst:pl:dat:m3
SCMSie	SCMS	subst:sg:voc:m3
SCMSie	SCMS	subst:sg:loc:m3
SCMSem	SCMS	subst:sg:inst:m3
SCMSami	SCMS	subst:pl:inst:m3
SCMSach	SCMS	subst:pl:loc:m3
SChD	SChD	subst:sg.pl:nom.gen.dat.acc.inst.loc.voc:n:ncol
SB	SB	subst:sg.pl:nom.gen.dat.acc.inst.loc.voc:n:ncol
SB	SB	subst:sg.pl:nom.gen.dat.acc.inst.loc.voc:f
SASy	SAS	subst:pl:nom.acc.voc:m3
SASu	SAS	subst:sg:gen:m3
SAS	SAS	subst:sg:nom.acc:m3
SASów	SAS	subst:pl:gen:m3
SASowi	SAS	subst:sg:dat:m3
SASom	SAS	subst:pl:dat:m3
SASie	SAS	subst:sg:voc:m3
SASie	SAS	subst:sg:loc:m3
SASem	SAS	subst:sg:inst:m3
SASami	SAS	subst:pl:inst:m3
SASach	SAS	subst:pl:loc:m3
SARSy	SARS	subst:pl:nom.acc.voc:m3
SARSu	SARS	subst:sg:gen:m3
SARS	SARS	subst:sg.pl:nom.gen.dat.acc.inst.loc.voc:m3
SARS	SARS	subst:sg:nom.acc:m3
SARSów	SARS	subst:pl:gen:m3
SARSowi	SARS	subst:sg:dat:m3
SARSom	SARS	subst:pl:dat:m3
SARSie	SARS	subst:sg:voc:m3
SARSie	SARS	subst:sg:loc:m3
SARSem	SARS	subst:sg:inst:m3
SARSami	SARS	subst:pl:inst:m3
SARSach	SARS	subst:pl:loc:m3
SAPA	SAPA	subst:sg.pl:nom.gen.dat.acc.inst.loc.voc:f
SABENy	SABENA	subst:sg:gen:f
SABENy	SABENA	subst:pl:nom.acc.voc:f
SABEN	SABENA	subst:pl:gen:f
SABENo	SABENA	subst:sg:voc:f
SABENom	SABENA	subst:pl:dat:f
SABENie	SABENA	subst:sg:dat.loc:f
SABENę	SABENA	subst:sg:acc:f
SABENą	SABENA	subst:sg:inst:f
SABENA	SABENA	subst:sg:nom:f
SABENami	SABENA	subst:pl:inst:f
SABENach	SABENA	subst:pl:loc:f
SAABy	SAAB	subst:pl:nom.acc.voc:m3
SAAB	SAAB	subst:sg:nom.acc:m3
SAABów	SAAB	subst:pl:gen:m3
SAABowi	SAAB	subst:sg:dat:m3
SAABom	SAAB	subst:pl:dat:m3
SAABie	SAAB	subst:sg:voc:m3
SAABie	SAAB	subst:sg:loc:m3
SAABem	SAAB	subst:sg:inst:m3
SAABa	SAAB	subst:sg:gen:m3
SAABami	SAAB	subst:pl:inst:m3
SAABach	SAAB	subst:pl:loc:m3
SAA	SAA	subst:sg.pl:nom.gen.dat.acc.inst.loc.voc:n:ncol
SAA	SAA	subst:sg.pl:nom.gen.dat.acc.inst.loc.voc:m3
S.A.	S.A.	subst:sg.pl:nom.gen.dat.acc.inst.loc.voc:n:ncol
S.A.	S.A.	subst:sg.pl:nom.gen.dat.acc.inst.loc.voc:f
SA	SA	subst:sg.pl:nom.gen.dat.acc.inst.loc.voc:n:ncol
SA	SA	subst:sg.pl:nom.gen.dat.acc.inst.loc.voc:f
RWPG	RWPG	subst:sg.pl:nom.gen.dat.acc.inst.loc.voc:n:ncol
RWPG	RWPG	subst:sg.pl:nom.gen.dat.acc.inst.loc.voc:f
RWE	RWE	subst:sg.pl:nom.gen.dat.acc.inst.loc.voc:n:ncol
RUPy	RUP	subst:pl:nom.acc.voc:m3
RUPu	RUP	subst:sg:gen:m3
RUP	RUP	subst:sg:nom.acc:m3
RUPów	RUP	subst:pl:gen:m3
RUPowi	RUP	subst:sg:dat:m3
RUPom	RUP	subst:pl:dat:m3
RUPie	RUP	subst:sg:voc:m3
RUPie	RUP	subst:sg:loc:m3
RUPem	RUP	subst:sg:inst:m3
RUPami	RUP	subst:pl:inst:m3
RUPach	RUP	subst:pl:loc:m3
RUMy	RUM	subst:pl:nom.acc.voc:m3
RUMu	RUM	subst:sg:gen:m3
RUM	RUM	subst:sg:nom.acc:m3
RUMów	RUM	subst:pl:gen:m3
RUMowi	RUM	subst:sg:dat:m3
RUMom	RUM	subst:pl:dat:m3
RUMie	RUM	subst:sg:voc:m3
RUMie	RUM	subst:sg:loc:m3
RUMem	RUM	subst:sg:inst:m3
RUMami	RUM	subst:pl:inst:m3
RUMach	RUM	subst:pl:loc:m3
RSW	RSW	subst:sg.pl:nom.gen.dat.acc.inst.loc.voc:n:ncol
RSW	RSW	subst:sg.pl:nom.gen.dat.acc.inst.loc.voc:f
RSHA	RSHA	subst:sg.pl:nom.gen.dat.acc.inst.loc.voc:n:ncol
RSHA	RSHA	subst:sg.pl:nom.gen.dat.acc.inst.loc.voc:m3
RPU	RPU	subst:sg.pl:nom.gen.dat.acc.inst.loc.voc:m3
RPO	RPO	subst:sg.pl:nom.gen.dat.acc.inst.loc.voc:m3
RPNy	RPN	subst:pl:nom.acc.voc:m3
RPNu	RPN	subst:sg:gen:m3
RPN	RPN	subst:sg:nom.acc:m3
RPNów	RPN	subst:pl:gen:m3
RPNowi	RPN	subst:sg:dat:m3
RPNom	RPN	subst:pl:dat:m3
RPNie	RPN	subst:sg:voc:m3
RPNie	RPN	subst:sg:loc:m3
RPNem	RPN	subst:sg:inst:m3
RPNami	RPN	subst:pl:inst:m3
RPNach	RPN	subst:pl:loc:m3
RPA	RPA	subst:sg.pl:nom.gen.dat.acc.inst.loc.voc:f
RP	RP	subst:sg.pl:nom.gen.dat.acc.inst.loc.voc:f
RORze	ROR	subst:sg:voc:m3
RORze	ROR	subst:sg:loc:m3
RORy	ROR	subst:pl:nom.acc.voc:m3
RORu	ROR	subst:sg:gen:m3
ROR	ROR	subst:sg:nom.acc:m3
RORów	ROR	subst:pl:gen:m3
RORowi	ROR	subst:sg:dat:m3
RORom	ROR	subst:pl:dat:m3
RORem	ROR	subst:sg:inst:m3
RORami	ROR	subst:pl:inst:m3
RORach	ROR	subst:pl:loc:m3
ROPCiO	ROPCiO	subst:sg.pl:nom.gen.dat.acc.inst.loc.voc:n:ncol
ROPCiO	ROPCiO	subst:sg.pl:nom.gen.dat.acc.inst.loc.voc:m3
ROPy	ROP	subst:pl:nom.acc.voc:m3
ROPu	ROP	subst:sg:gen:m3
ROP	ROP	subst:sg:nom.acc:m3
ROPów	ROP	subst:pl:gen:m3
ROPowi	ROP	subst:sg:dat:m3
ROPom	ROP	subst:pl:dat:m3
ROPie	ROP	subst:sg:voc:m3
ROPie	ROP	subst:sg:loc:m3
ROPem	ROP	subst:sg:inst:m3
ROPami	ROP	subst:pl:inst:m3
ROPach	ROP	subst:pl:loc:m3
ROMy	ROM	subst:pl:nom.acc.voc:m3
ROMu	ROM	subst:sg:gen:m3
ROM	ROM	subst:sg:nom.acc:m3
ROMów	ROM	subst:pl:gen:m3
ROMowi	ROM	subst:sg:dat:m3
ROMom	ROM	subst:pl:dat:m3
ROMie	ROM	subst:sg:voc:m3
ROMie	ROM	subst:sg:loc:m3
ROMem	ROM	subst:sg:inst:m3
ROMami	ROM	subst:pl:inst:m3
ROMach	ROM	subst:pl:loc:m3
RNy	RN:s2	subst:pl:nom.acc.voc:m3
RNu	RN:s2	subst:sg:gen:m3
RN	RN:s2	subst:sg.pl:nom.gen.dat.acc.inst.loc.voc:f
RN	RN:s2	subst:sg:nom.acc:m3
RNów	RN:s2	subst:pl:gen:m3
RNowi	RN:s2	subst:sg:dat:m3
RNom	RN:s2	subst:pl:dat:m3
RNie	RN:s2	subst:sg:voc:m3
RNie	RN:s2	subst:sg:loc:m3
RNem	RN:s2	subst:sg:inst:m3
RNami	RN:s2	subst:pl:inst:m3
RNach	RN:s2	subst:pl:loc:m3
RNy	RN:s1	subst:pl:nom.acc.voc:m3
RNu	RN:s1	subst:sg:gen:m3
RN	RN:s1	subst:sg.pl:nom.gen.dat.acc.inst.loc.voc:m3
RN	RN:s1	subst:sg:nom.acc:m3
RNów	RN:s1	subst:pl:gen:m3
RNowi	RN:s1	subst:sg:dat:m3
RNom	RN:s1	subst:pl:dat:m3
RNie	RN:s1	subst:sg:voc:m3
RNie	RN:s1	subst:sg:loc:m3
RNem	RN:s1	subst:sg:inst:m3
RNami	RN:s1	subst:pl:inst:m3
RNach	RN:s1	subst:pl:loc:m3
RNA	RNA	subst:sg.pl:nom.gen.dat.acc.inst.loc.voc:n:ncol
RNA	RNA	subst:sg.pl:nom.gen.dat.acc.inst.loc.voc:m3
RMFy	RMF	subst:pl:nom.acc.voc:m3
RMFu	RMF	subst:sg:gen:m3
RMF	RMF	subst:sg.pl:nom.gen.dat.acc.inst.loc.voc:n:ncol
RMF	RMF	subst:sg:nom.acc:m3
RMFów	RMF	subst:pl:gen:m3
RMFowi	RMF	subst:sg:dat:m3
RMFom	RMF	subst:pl:dat:m3
RMFie	RMF	subst:sg:voc:m3
RMFie	RMF	subst:sg:loc:m3
RMFem	RMF	subst:sg:inst:m3
RMFami	RMF	subst:pl:inst:m3
RMFach	RMF	subst:pl:loc:m3
RMy	RM	subst:pl:nom.acc.voc:m3
RMu	RM	subst:sg:gen:m3
RM	RM	subst:sg.pl:nom.gen.dat.acc.inst.loc.voc:f
RM	RM	subst:sg:nom.acc:m3
RMów	RM	subst:pl:gen:m3
RMowi	RM	subst:sg:dat:m3
RMom	RM	subst:pl:dat:m3
RMie	RM	subst:sg:voc:m3
RMie	RM	subst:sg:loc:m3
RMem	RM	subst:sg:inst:m3
RMami	RM	subst:pl:inst:m3
RMach	RM	subst:pl:loc:m3
RGO	RGO	subst:sg.pl:nom.gen.dat.acc.inst.loc.voc:n:ncol
RGO	RGO	subst:sg.pl:nom.gen.dat.acc.inst.loc.voc:f
RFNy	RFN	subst:pl:nom.acc.voc:m3
RFNu	RFN	subst:sg:gen:m3
RFN	RFN	subst:sg:nom.acc:m3
RFNów	RFN	subst:pl:gen:m3
RFNowi	RFN	subst:sg:dat:m3
RFNom	RFN	subst:pl:dat:m3
RFNie	RFN	subst:sg:voc:m3
RFNie	RFN	subst:sg:loc:m3
RFNem	RFN	subst:sg:inst:m3
RFNami	RFN	subst:pl:inst:m3
RFNach	RFN	subst:pl:loc:m3
RENy	REN	subst:pl:nom.acc.voc:m3
RENu	REN	subst:sg:gen:m3
REN	REN	subst:sg.pl:nom.gen.dat.acc.inst.loc.voc:f
REN	REN	subst:sg:nom.acc:m3
RENów	REN	subst:pl:gen:m3
RENowi	REN	subst:sg:dat:m3
RENom	REN	subst:pl:dat:m3
RENie	REN	subst:sg:voc:m3
RENie	REN	subst:sg:loc:m3
RENem	REN	subst:sg:inst:m3
RENami	REN	subst:pl:inst:m3
RENach	REN	subst:pl:loc:m3
REM	REM	subst:sg.pl:nom.gen.dat.acc.inst.loc.voc:m3
REGONy	REGON	subst:pl:nom.acc.voc:m3
REGONu	REGON	subst:sg:gen:m3
REGON	REGON	subst:sg:nom.acc:m3
REGONów	REGON	subst:pl:gen:m3
REGONowi	REGON	subst:sg:dat:m3
REGONom	REGON	subst:pl:dat:m3
REGONie	REGON	subst:sg:voc:m3
REGONie	REGON	subst:sg:loc:m3
REGONem	REGON	subst:sg:inst:m3
REGONami	REGON	subst:pl:inst:m3
REGONach	REGON	subst:pl:loc:m3
RE	RE	subst:sg.pl:nom.gen.dat.acc.inst.loc.voc:n:ncol
RE	RE	subst:sg.pl:nom.gen.dat.acc.inst.loc.voc:f
RdRze	RdR	subst:sg:voc:m3
RdRze	RdR	subst:sg:loc:m3
RdRy	RdR	subst:pl:nom.acc.voc:m3
RdRu	RdR	subst:sg:gen:m3
RdR	RdR	subst:sg:nom.acc:m3
RdRów	RdR	subst:pl:gen:m3
RdRowi	RdR	subst:sg:dat:m3
RdRom	RdR	subst:pl:dat:m3
RdRem	RdR	subst:sg:inst:m3
RdRami	RdR	subst:pl:inst:m3
RdRach	RdR	subst:pl:loc:m3
RCA	RCA	subst:sg.pl:nom.gen.dat.acc.inst.loc.voc:n:ncol
RASy	RAS	subst:pl:nom.acc.voc:m3
RASu	RAS	subst:sg:gen:m3
RAS	RAS	subst:sg.pl:nom.gen.dat.acc.inst.loc.voc:f
RAS	RAS	subst:sg:nom.acc:m3
RASów	RAS	subst:pl:gen:m3
RASowi	RAS	subst:sg:dat:m3
RASom	RAS	subst:pl:dat:m3
RASie	RAS	subst:sg:voc:m3
RASie	RAS	subst:sg:loc:m3
RASem	RAS	subst:sg:inst:m3
RASami	RAS	subst:pl:inst:m3
RASach	RAS	subst:pl:loc:m3
RAMy	RAM	subst:pl:nom.acc.voc:m3
RAMu	RAM	subst:sg:gen:m3
RAM	RAM	subst:sg:nom.acc:m3
RAMów	RAM	subst:pl:gen:m3
RAMowi	RAM	subst:sg:dat:m3
RAMom	RAM	subst:pl:dat:m3
RAMie	RAM	subst:sg:voc:m3
RAMie	RAM	subst:sg:loc:m3
RAMem	RAM	subst:sg:inst:m3
RAMami	RAM	subst:pl:inst:m3
RAMach	RAM	subst:pl:loc:m3
RAIu	RAI	subst:sg:voc:m3
RAIu	RAI	subst:sg:loc:m3
RAIu	RAI	subst:sg:gen:m3
RAI	RAI	subst:sg.pl:nom.gen.dat.acc.inst.loc.voc:n:ncol
RAI	RAI	subst:sg:nom.acc:m3
RAIowi	RAI	subst:sg:dat:m3
RAIom	RAI	subst:pl:dat:m3
RAIi	RAI	subst:pl:gen:m3
RAIe	RAI	subst:pl:nom.acc.voc:m3
RAIem	RAI	subst:sg:inst:m3
RAIami	RAI	subst:pl:inst:m3
RAIach	RAI	subst:pl:loc:m3
RAFy	RAF	subst:pl:nom.acc.voc:m3
RAFu	RAF	subst:sg:gen:m3
RAF	RAF	subst:sg:nom.acc:m3
RAFów	RAF	subst:pl:gen:m3
RAFowi	RAF	subst:sg:dat:m3
RAFom	RAF	subst:pl:dat:m3
RAFie	RAF	subst:sg:voc:m3
RAFie	RAF	subst:sg:loc:m3
RAFem	RAF	subst:sg:inst:m3
RAFami	RAF	subst:pl:inst:m3
RAFach	RAF	subst:pl:loc:m3
QAL	QAL	subst:sg.pl:nom.gen.dat.acc.inst.loc.voc:m3
Q	Q	subst:sg.pl:nom.gen.dat.acc.inst.loc.voc:n:ncol
PŻMy	PŻM	subst:pl:nom.acc.voc:m3
PŻMu	PŻM	subst:sg:gen:m3
PŻM	PŻM	subst:sg:nom.acc:m3
PŻMów	PŻM	subst:pl:gen:m3
PŻMowi	PŻM	subst:sg:dat:m3
PŻMom	PŻM	subst:pl:dat:m3
PŻMie	PŻM	subst:sg:voc:m3
PŻMie	PŻM	subst:sg:loc:m3
PŻMem	PŻM	subst:sg:inst:m3
PŻMami	PŻM	subst:pl:inst:m3
PŻMach	PŻM	subst:pl:loc:m3
PZU	PZU	subst:sg.pl:nom.gen.dat.acc.inst.loc.voc:n:ncol
PZU	PZU	subst:sg.pl:nom.gen.dat.acc.inst.loc.voc:m3
PZPRze	PZPR	subst:sg:voc:m3
PZPRze	PZPR	subst:sg:loc:m3
PZPRy	PZPR	subst:pl:nom.acc.voc:m3
PZPRu	PZPR	subst:sg:gen:m3
PZPR	PZPR	subst:sg.pl:nom.gen.dat.acc.inst.loc.voc:m3
PZPR	PZPR	subst:sg.pl:nom.gen.dat.acc.inst.loc.voc:f
PZPR	PZPR	subst:sg:nom.acc:m3
PZPRów	PZPR	subst:pl:gen:m3
PZPRowi	PZPR	subst:sg:dat:m3
PZPRom	PZPR	subst:pl:dat:m3
PZPRem	PZPR	subst:sg:inst:m3
PZPRami	PZPR	subst:pl:inst:m3
PZPRach	PZPR	subst:pl:loc:m3
PZPNy	PZPN	subst:pl:nom.acc.voc:m3
PZPNu	PZPN	subst:sg:gen:m3
PZPN	PZPN	subst:sg:nom.acc:m3
PZPNów	PZPN	subst:pl:gen:m3
PZPNowi	PZPN	subst:sg:dat:m3
PZPNom	PZPN	subst:pl:dat:m3
PZPNie	PZPN	subst:sg:voc:m3
PZPNie	PZPN	subst:sg:loc:m3
PZPNem	PZPN	subst:sg:inst:m3
PZPNami	PZPN	subst:pl:inst:m3
PZPNach	PZPN	subst:pl:loc:m3
PZH	PZH	subst:sg.pl:nom.gen.dat.acc.inst.loc.voc:n:ncol
PZH	PZH	subst:sg.pl:nom.gen.dat.acc.inst.loc.voc:m3
PZG	PZG	subst:sg.pl:nom.gen.dat.acc.inst.loc.voc:n:ncol
PZG	PZG	subst:sg.pl:nom.gen.dat.acc.inst.loc.voc:m3
PZE	PZE	subst:sg.pl:nom.gen.dat.acc.inst.loc.voc:n:ncol
PZE	PZE	subst:sg.pl:nom.gen.dat.acc.inst.loc.voc:m3
PWNy	PWN	subst:pl:nom.acc.voc:m3
PWNu	PWN	subst:sg:gen:m3
PWN	PWN	subst:sg:nom.acc:m3
PWNów	PWN	subst:pl:gen:m3
PWNowi	PWN	subst:sg:dat:m3
PWNom	PWN	subst:pl:dat:m3
PWNie	PWN	subst:sg:voc:m3
PWNie	PWN	subst:sg:loc:m3
PWNem	PWN	subst:sg:inst:m3
PWNami	PWN	subst:pl:inst:m3
PWNach	PWN	subst:pl:loc:m3
PW	PW	subst:sg.pl:nom.gen.dat.acc.inst.loc.voc:n:ncol
PW	PW	subst:sg.pl:nom.gen.dat.acc.inst.loc.voc:f
PVC	PVC	subst:sg.pl:nom.gen.dat.acc.inst.loc.voc:n:ncol
PVC	PVC	subst:sg.pl:nom.gen.dat.acc.inst.loc.voc:m3
PURze	PUR	subst:sg:voc:m3
PURze	PUR	subst:sg:loc:m3
PURy	PUR	subst:pl:nom.acc.voc:m3
PURu	PUR	subst:sg:gen:m3
PUR	PUR	subst:sg:nom.acc:m3
PURów	PUR	subst:pl:gen:m3
PURowi	PUR	subst:sg:dat:m3
PURom	PUR	subst:pl:dat:m3
PURem	PUR	subst:sg:inst:m3
PURami	PUR	subst:pl:inst:m3
PURach	PUR	subst:pl:loc:m3
PTTK	PTTK	subst:sg.pl:nom.gen.dat.acc.inst.loc.voc:n:ncol
PTK	PTK	subst:sg.pl:nom.gen.dat.acc.inst.loc.voc:f
PTJ	PTJ	subst:sg.pl:nom.gen.dat.acc.inst.loc.voc:n:ncol
PTJ	PTJ	subst:sg:nom.acc:m3
PTJoty	PTJ	subst:pl:nom.acc.voc:m3
PTJotu	PTJ	subst:sg:gen:m3
PTJotów	PTJ	subst:pl:gen:m3
PTJotowi	PTJ	subst:sg:dat:m3
PTJotom	PTJ	subst:pl:dat:m3
PTJotem	PTJ	subst:sg:inst:m3
PTJotami	PTJ	subst:pl:inst:m3
PTJotach	PTJ	subst:pl:loc:m3
PTJocie	PTJ	subst:sg:voc:m3
PTJocie	PTJ	subst:sg:loc:m3
PTE	PTE	subst:sg.pl:nom.gen.dat.acc.inst.loc.voc:n:ncol
PŚu	PŚ	subst:sg:voc:m3
PŚu	PŚ	subst:sg:loc:m3
PŚu	PŚ	subst:sg:gen:m3
PŚ	PŚ	subst:sg.pl:nom.gen.dat.acc.inst.loc.voc:f
PŚ	PŚ	subst:sg:nom.acc:m3
PŚów	PŚ	subst:pl:gen:m3
PŚowi	PŚ	subst:sg:dat:m3
PŚom	PŚ	subst:pl:dat:m3
PŚe	PŚ	subst:pl:nom.acc.voc:m3
PŚem	PŚ	subst:sg:inst:m3
PŚami	PŚ	subst:pl:inst:m3
PŚach	PŚ	subst:pl:loc:m3
PSSy	PSS	subst:pl:nom.acc.voc:m3
PSSu	PSS	subst:sg:gen:m3
PSS	PSS	subst:sg.pl:nom.gen.dat.acc.inst.loc.voc:m3
PSS	PSS	subst:sg:nom.acc:m3
PSSów	PSS	subst:pl:gen:m3
PSSowi	PSS	subst:sg:dat:m3
PSSom	PSS	subst:pl:dat:m3
PSSie	PSS	subst:sg:voc:m3
PSSie	PSS	subst:sg:loc:m3
PSSem	PSS	subst:sg:inst:m3
PSSami	PSS	subst:pl:inst:m3
PSSach	PSS	subst:pl:loc:m3
PSLu	PSL	subst:sg:voc:m3
PSLu	PSL	subst:sg:loc:m3
PSLu	PSL	subst:sg:gen:m3
PSL	PSL	subst:sg.pl:nom.gen.dat.acc.inst.loc.voc:n:ncol
PSL	PSL	subst:sg.pl:nom.gen.dat.acc.inst.loc.voc:m3
PSL	PSL	subst:sg:nom.acc:m3
PSLowi	PSL	subst:sg:dat:m3
PSLom	PSL	subst:pl:dat:m3
PSLi	PSL	subst:pl:gen:m3
PSLe	PSL	subst:pl:nom.acc.voc:m3
PSLem	PSL	subst:sg:inst:m3
PSLami	PSL	subst:pl:inst:m3
PSLach	PSL	subst:pl:loc:m3
PSy	PS	subst:pl:nom.acc.voc:m3
PSu	PS	subst:sg:gen:m3
PS	PS	subst:sg.pl:nom.gen.dat.acc.inst.loc.voc:f
PS	PS	subst:sg:nom.acc:m3
PSów	PS	subst:pl:gen:m3
PSowi	PS	subst:sg:dat:m3
PSom	PS	subst:pl:dat:m3
PSie	PS	subst:sg:voc:m3
PSie	PS	subst:sg:loc:m3
PSem	PS	subst:sg:inst:m3
PSami	PS	subst:pl:inst:m3
PSach	PS	subst:pl:loc:m3
PR	PR:s2	subst:sg.pl:nom.gen.dat.acc.inst.loc.voc:n:ncol
PRze	PR:s1	subst:sg:voc:m3
PRze	PR:s1	subst:sg:loc:m3
PRy	PR:s1	subst:pl:nom.acc.voc:m3
PRu	PR:s1	subst:sg:gen:m3
PR	PR:s1	subst:sg:nom.acc:m3
PRów	PR:s1	subst:pl:gen:m3
PRowi	PR:s1	subst:sg:dat:m3
PRom	PR:s1	subst:pl:dat:m3
PRem	PR:s1	subst:sg:inst:m3
PRami	PR:s1	subst:pl:inst:m3
PRach	PR:s1	subst:pl:loc:m3
PRSy	PRS	subst:pl:nom.acc.voc:m3
PRSu	PRS	subst:sg:gen:m3
PRS	PRS	subst:sg:nom.acc:m3
PRSów	PRS	subst:pl:gen:m3
PRSowi	PRS	subst:sg:dat:m3
PRSom	PRS	subst:pl:dat:m3
PRSie	PRS	subst:sg:voc:m3
PRSie	PRS	subst:sg:loc:m3
PRSem	PRS	subst:sg:inst:m3
PRSami	PRS	subst:pl:inst:m3
PRSach	PRS	subst:pl:loc:m3
PRONy	PRON	subst:pl:nom.acc.voc:m3
PRONu	PRON	subst:sg:gen:m3
PRON	PRON	subst:sg:nom.acc:m3
PRONów	PRON	subst:pl:gen:m3
PRONowi	PRON	subst:sg:dat:m3
PRONom	PRON	subst:pl:dat:m3
PRONie	PRON	subst:sg:voc:m3
PRONie	PRON	subst:sg:loc:m3
PRONem	PRON	subst:sg:inst:m3
PRONami	PRON	subst:pl:inst:m3
PRONach	PRON	subst:pl:loc:m3
PRLu	PRL	subst:sg:voc:m3
PRLu	PRL	subst:sg:loc:m3
PRLu	PRL	subst:sg:gen:m3
PRL	PRL	subst:sg.pl:nom.gen.dat.acc.inst.loc.voc:m3
PRL	PRL	subst:sg.pl:nom.gen.dat.acc.inst.loc.voc:f
PRL	PRL	subst:sg:nom.acc:m3
PRLowi	PRL	subst:sg:dat:m3
PRLom	PRL	subst:pl:dat:m3
PRLi	PRL	subst:pl:gen:m3
PRLe	PRL	subst:pl:nom.acc.voc:m3
PRLem	PRL	subst:sg:inst:m3
PRLami	PRL	subst:pl:inst:m3
PRLach	PRL	subst:pl:loc:m3
PRiTV	PRiTV	subst:sg.pl:nom.gen.dat.acc.inst.loc.voc:n:ncol
PPSy	PPS	subst:pl:nom.acc.voc:m3
PPSu	PPS	subst:sg:gen:m3
PPS	PPS	subst:sg:nom.acc:m3
PPSów	PPS	subst:pl:gen:m3
PPSowi	PPS	subst:sg:dat:m3
PPSom	PPS	subst:pl:dat:m3
PPSie	PPS	subst:sg:voc:m3
PPSie	PPS	subst:sg:loc:m3
PPSem	PPS	subst:sg:inst:m3
PPSami	PPS	subst:pl:inst:m3
PPSach	PPS	subst:pl:loc:m3
PPRze	PPR	subst:sg:voc:m3
PPRze	PPR	subst:sg:loc:m3
PPRy	PPR	subst:pl:nom.acc.voc:m3
PPRu	PPR	subst:sg:gen:m3
PPR	PPR	subst:sg.pl:nom.gen.dat.acc.inst.loc.voc:f
PPR	PPR	subst:sg:nom.acc:m3
PPRów	PPR	subst:pl:gen:m3
PPRowi	PPR	subst:sg:dat:m3
PPRom	PPR	subst:pl:dat:m3
PPRem	PPR	subst:sg:inst:m3
PPRami	PPR	subst:pl:inst:m3
PPRach	PPR	subst:pl:loc:m3
PPPP	PPPP	subst:sg.pl:nom.gen.dat.acc.inst.loc.voc:n:ncol
PPPP	PPPP	subst:sg.pl:nom.gen.dat.acc.inst.loc.voc:f
PPP	PPP	subst:sg.pl:nom.gen.dat.acc.inst.loc.voc:n:ncol
PPP	PPP	subst:sg.pl:nom.gen.dat.acc.inst.loc.voc:f
PPLu	PPL	subst:sg:voc:m3
PPLu	PPL	subst:sg:loc:m3
PPLu	PPL	subst:sg:gen:m3
PPL	PPL	subst:sg.pl:nom.gen.dat.acc.inst.loc.voc:n:ncol
PPL	PPL	subst:sg.pl:nom.gen.dat.acc.inst.loc.voc:m3
PPL	PPL	subst:sg:nom.acc:m3
PPLowi	PPL	subst:sg:dat:m3
PPLom	PPL	subst:pl:dat:m3
PPLi	PPL	subst:pl:gen:m3
PPLe	PPL	subst:pl:nom.acc.voc:m3
PPLem	PPL	subst:sg:inst:m3
PPLami	PPL	subst:pl:inst:m3
PPLach	PPL	subst:pl:loc:m3
POW	POW	subst:sg.pl:nom.gen.dat.acc.inst.loc.voc:n:ncol
POW	POW	subst:sg.pl:nom.gen.dat.acc.inst.loc.voc:f
PO	PO	subst:sg.pl:nom.gen.dat.acc.inst.loc.voc:n:ncol
PO	PO	subst:sg.pl:nom.gen.dat.acc.inst.loc.voc:f
PNB	PNB	subst:sg.pl:nom.gen.dat.acc.inst.loc.voc:n:ncol
PNB	PNB	subst:sg.pl:nom.gen.dat.acc.inst.loc.voc:m3
PNy	PN	subst:pl:nom.acc.voc:m3
PNu	PN	subst:sg:gen:m3
PN	PN	subst:sg.pl:nom.gen.dat.acc.inst.loc.voc:f
PN	PN	subst:sg:nom.acc:m3
PNów	PN	subst:pl:gen:m3
PNowi	PN	subst:sg:dat:m3
PNom	PN	subst:pl:dat:m3
PNie	PN	subst:sg:voc:m3
PNie	PN	subst:sg:loc:m3
PNem	PN	subst:sg:inst:m3
PNami	PN	subst:pl:inst:m3
PNach	PN	subst:pl:loc:m3
PŁy	PŁ	subst:pl:nom.acc.voc:m3
PŁu	PŁ	subst:sg:voc:m3
PŁu	PŁ	subst:sg:loc:m3
PŁu	PŁ	subst:sg:gen:m3
PŁ	PŁ	subst:sg:nom.acc:m3
PŁów	PŁ	subst:pl:gen:m3
PŁowi	PŁ	subst:sg:dat:m3
PŁom	PŁ	subst:pl:dat:m3
PŁem	PŁ	subst:sg:inst:m3
PŁami	PŁ	subst:pl:inst:m3
PŁach	PŁ	subst:pl:loc:m3
PLO	PLO	subst:sg.pl:nom.gen.dat.acc.inst.loc.voc:n:ncol
PLLu	PLL	subst:sg:voc:m3
PLLu	PLL	subst:sg:loc:m3
PLLu	PLL	subst:sg:gen:m3
PLL	PLL	subst:sg:nom.acc:m3
PLLowi	PLL	subst:sg:dat:m3
PLLom	PLL	subst:pl:dat:m3
PLLi	PLL	subst:pl:gen:m3
PLLe	PLL	subst:pl:nom.acc.voc:m3
PLLem	PLL	subst:sg:inst:m3
PLLami	PLL	subst:pl:inst:m3
PLLach	PLL	subst:pl:loc:m3
PKZP	PKZP	subst:sg.pl:nom.gen.dat.acc.inst.loc.voc:n:ncol
PKZP	PKZP	subst:sg.pl:nom.gen.dat.acc.inst.loc.voc:f
PKWNy	PKWN	subst:pl:nom.acc.voc:m3
PKWNu	PKWN	subst:sg:gen:m3
PKWN	PKWN	subst:sg:nom.acc:m3
PKWNów	PKWN	subst:pl:gen:m3
PKWNowi	PKWN	subst:sg:dat:m3
PKWNom	PKWN	subst:pl:dat:m3
PKWNie	PKWN	subst:sg:voc:m3
PKWNie	PKWN	subst:sg:loc:m3
PKWNem	PKWN	subst:sg:inst:m3
PKWNami	PKWN	subst:pl:inst:m3
PKWNach	PKWN	subst:pl:loc:m3
PKSy	PKS	subst:pl:nom.acc.voc:m3
PKSu	PKS	subst:sg:gen:m3
PKS	PKS	subst:sg.pl:nom.gen.dat.acc.inst.loc.voc:m3
PKS	PKS	subst:sg:nom.acc:m3
PKSów	PKS	subst:pl:gen:m3
PKSowi	PKS	subst:sg:dat:m3
PKSom	PKS	subst:pl:dat:m3
PKSie	PKS	subst:sg:voc:m3
PKSie	PKS	subst:sg:loc:m3
PKSem	PKS	subst:sg:inst:m3
PKSami	PKS	subst:pl:inst:m3
PKSach	PKS	subst:pl:loc:m3
PKP	PKP	subst:sg.pl:nom.gen.dat.acc.inst.loc.voc:n:ncol
PKP	PKP	subst:pl:nom.gen.dat.acc.inst.loc.voc:n:pt
PKOlu	PKOl	subst:sg:voc:m3
PKOlu	PKOl	subst:sg:loc:m3
PKOlu	PKOl	subst:sg:gen:m3
PKOl	PKOl	subst:sg:nom.acc:m3
PKOlowi	PKOl	subst:sg:dat:m3
PKOlom	PKOl	subst:pl:dat:m3
PKOli	PKOl	subst:pl:gen:m3
PKOle	PKOl	subst:pl:nom.acc.voc:m3
PKOlem	PKOl	subst:sg:inst:m3
PKOlami	PKOl	subst:pl:inst:m3
PKOlach	PKOl	subst:pl:loc:m3
PKO	PKO	subst:sg.pl:nom.gen.dat.acc.inst.loc.voc:n:ncol
PKO	PKO	subst:sg.pl:nom.gen.dat.acc.inst.loc.voc:f
PKN	PKN	subst:sg.pl:nom.gen.dat.acc.inst.loc.voc:m3
PKLD	PKLD	subst:sg.pl:nom.gen.dat.acc.inst.loc.voc:m3
PKiNy	PKiN	subst:pl:nom.acc.voc:m3
PKiNu	PKiN	subst:sg:gen:m3
PKiN	PKiN	subst:sg:nom.acc:m3
PKiNów	PKiN	subst:pl:gen:m3
PKiNowi	PKiN	subst:sg:dat:m3
PKiNom	PKiN	subst:pl:dat:m3
PKiNie	PKiN	subst:sg:voc:m3
PKiNie	PKiN	subst:sg:loc:m3
PKiNem	PKiN	subst:sg:inst:m3
PKiNami	PKiN	subst:pl:inst:m3
PKiNach	PKiN	subst:pl:loc:m3
PKFy	PKF	subst:pl:nom.acc.voc:m3
PKFu	PKF	subst:sg:gen:m3
PKF	PKF	subst:sg.pl:nom.gen.dat.acc.inst.loc.voc:f
PKF	PKF	subst:sg:nom.acc:m3
PKFów	PKF	subst:pl:gen:m3
PKFowi	PKF	subst:sg:dat:m3
PKFom	PKF	subst:pl:dat:m3
PKFie	PKF	subst:sg:voc:m3
PKFie	PKF	subst:sg:loc:m3
PKFem	PKF	subst:sg:inst:m3
PKFami	PKF	subst:pl:inst:m3
PKFach	PKF	subst:pl:loc:m3
PKD	PKD	subst:sg.pl:nom.gen.dat.acc.inst.loc.voc:n:ncol
PKD	PKD	subst:sg.pl:nom.gen.dat.acc.inst.loc.voc:f
PKB	PKB	subst:sg.pl:nom.gen.dat.acc.inst.loc.voc:n:ncol
PKB	PKB	subst:sg.pl:nom.gen.dat.acc.inst.loc.voc:m3
PK	PK	subst:sg.pl:nom.gen.dat.acc.inst.loc.voc:n:ncol
PK	PK	subst:sg.pl:nom.gen.dat.acc.inst.loc.voc:f
PIWy	PIW	subst:pl:nom.acc.voc:m3
PIWu	PIW	subst:sg:gen:m3
PIW	PIW	subst:sg:nom.acc:m3
PIWów	PIW	subst:pl:gen:m3
PIWowi	PIW	subst:sg:dat:m3
PIWom	PIW	subst:pl:dat:m3
PIWie	PIW	subst:sg:voc:m3
PIWie	PIW	subst:sg:loc:m3
PIWem	PIW	subst:sg:inst:m3
PIWami	PIW	subst:pl:inst:m3
PIWach	PIW	subst:pl:loc:m3
PITy	PIT:s2	subst:pl:nom.acc.voc:m3
PITu	PIT:s2	subst:sg:gen:m3
PIT	PIT:s2	subst:sg.pl:nom.gen.dat.acc.inst.loc.voc:f
PIT	PIT:s2	subst:sg:nom.acc:m3
PITów	PIT:s2	subst:pl:gen:m3
PITowi	PIT:s2	subst:sg:dat:m3
PITom	PIT:s2	subst:pl:dat:m3
PITem	PIT:s2	subst:sg:inst:m3
PITami	PIT:s2	subst:pl:inst:m3
PITach	PIT:s2	subst:pl:loc:m3
Picie	PIT:s2	subst:sg:voc:m3
Picie	PIT:s2	subst:sg:loc:m3
PITy	PIT:s1	subst:pl:nom.acc.voc:m3
PITu	PIT:s1	subst:sg:gen:m3
PIT	PIT:s1	subst:sg.pl:nom.gen.dat.acc.inst.loc.voc:m3
PIT	PIT:s1	subst:sg:nom.acc:m3
PITów	PIT:s1	subst:pl:gen:m3
PITowi	PIT:s1	subst:sg:dat:m3
PITom	PIT:s1	subst:pl:dat:m3
PITem	PIT:s1	subst:sg:inst:m3
PITami	PIT:s1	subst:pl:inst:m3
PITach	PIT:s1	subst:pl:loc:m3
PIcie	PIT:s1	subst:sg:voc:m3
Picie	PIT:s1	subst:sg:voc:m3
PIcie	PIT:s1	subst:sg:loc:m3
Picie	PIT:s1	subst:sg:loc:m3
PiSy	PiS	subst:pl:nom.acc.voc:m3
PiSu	PiS	subst:sg:gen:m3
PiS	PiS	subst:sg.pl:nom.gen.dat.acc.inst.loc.voc:n:ncol
PiS	PiS	subst:sg.pl:nom.gen.dat.acc.inst.loc.voc:f
PiS	PiS	subst:sg:nom.acc:m3
PiSów	PiS	subst:pl:gen:m3
PiSowi	PiS	subst:sg:dat:m3
PiSom	PiS	subst:pl:dat:m3
PiSie	PiS	subst:sg:voc:m3
PiSie	PiS	subst:sg:loc:m3
PiSem	PiS	subst:sg:inst:m3
PiSami	PiS	subst:pl:inst:m3
PiSach	PiS	subst:pl:loc:m3
PIPy	PIP:s2	subst:pl:nom.acc.voc:m3
PIPu	PIP:s2	subst:sg:gen:m3
PIP	PIP:s2	subst:sg.pl:nom.gen.dat.acc.inst.loc.voc:f
PIP	PIP:s2	subst:sg:nom.acc:m3
PIPów	PIP:s2	subst:pl:gen:m3
PIPowi	PIP:s2	subst:sg:dat:m3
PIPom	PIP:s2	subst:pl:dat:m3
PIPie	PIP:s2	subst:sg:voc:m3
PIPie	PIP:s2	subst:sg:loc:m3
PIPem	PIP:s2	subst:sg:inst:m3
PIPami	PIP:s2	subst:pl:inst:m3
PIPach	PIP:s2	subst:pl:loc:m3
PIPy	PIP:s1	subst:pl:nom.acc.voc:m3
PIPu	PIP:s1	subst:sg:gen:m3
PIP	PIP:s1	subst:sg:nom.acc:m3
PIPów	PIP:s1	subst:pl:gen:m3
PIPowi	PIP:s1	subst:sg:dat:m3
PIPom	PIP:s1	subst:pl:dat:m3
PIPie	PIP:s1	subst:sg:voc:m3
PIPie	PIP:s1	subst:sg:loc:m3
PIPem	PIP:s1	subst:sg:inst:m3
PIPami	PIP:s1	subst:pl:inst:m3
PIPach	PIP:s1	subst:pl:loc:m3
PINy	PIN	subst:pl:nom.acc.voc:m3
PINu	PIN	subst:sg:gen:m3
PIN	PIN	subst:sg:nom.acc:m3
PINów	PIN	subst:pl:gen:m3
PINowi	PIN	subst:sg:dat:m3
PINom	PIN	subst:pl:dat:m3
PINie	PIN	subst:sg:voc:m3
PINie	PIN	subst:sg:loc:m3
PINem	PIN	subst:sg:inst:m3
PINami	PIN	subst:pl:inst:m3
PINach	PIN	subst:pl:loc:m3
PIHy	PIH	subst:pl:nom.acc.voc:m3
PIHu	PIH	subst:sg:voc:m3
PIHu	PIH	subst:sg:loc:m3
PIHu	PIH	subst:sg:gen:m3
PIH	PIH	subst:sg:nom.acc:m3
PIHów	PIH	subst:pl:gen:m3
PIHowi	PIH	subst:sg:dat:m3
PIHom	PIH	subst:pl:dat:m3
PIHem	PIH	subst:sg:inst:m3
PIHami	PIH	subst:pl:inst:m3
PIHach	PIH	subst:pl:loc:m3
PIA	PIA	subst:sg.pl:nom.gen.dat.acc.inst.loc.voc:f
PHARE	PHARE	subst:sg.pl:nom.gen.dat.acc.inst.loc.voc:n:ncol
PHARE	PHARE	subst:sg.pl:nom.gen.dat.acc.inst.loc.voc:m3
PH	PH	subst:sg.pl:nom.gen.dat.acc.inst.loc.voc:n:ncol
pH	pH	subst:sg.pl:nom.gen.dat.acc.inst.loc.voc:n:ncol
PGRze	PGR	subst:sg:voc:m3
PGRze	PGR	subst:sg:loc:m3
PGRy	PGR	subst:pl:nom.acc.voc:m3
PGRu	PGR	subst:sg:gen:m3
PGR	PGR	subst:sg:nom.acc:m3
PGRów	PGR	subst:pl:gen:m3
PGRowi	PGR	subst:sg:dat:m3
PGRom	PGR	subst:pl:dat:m3
PGRem	PGR	subst:sg:inst:m3
PGRami	PGR	subst:pl:inst:m3
PGRach	PGR	subst:pl:loc:m3
PGNiG	PGNiG	subst:sg.pl:nom.gen.dat.acc.inst.loc.voc:n:ncol
PGMy	PGM	subst:pl:nom.acc.voc:m3
PGMu	PGM	subst:sg:gen:m3
PGM	PGM	subst:sg.pl:nom.gen.dat.acc.inst.loc.voc:n:ncol
PGM	PGM	subst:sg:nom.acc:m3
PGMów	PGM	subst:pl:gen:m3
PGMowi	PGM	subst:sg:dat:m3
PGMom	PGM	subst:pl:dat:m3
PGMie	PGM	subst:sg:voc:m3
PGMie	PGM	subst:sg:loc:m3
PGMem	PGM	subst:sg:inst:m3
PGMami	PGM	subst:pl:inst:m3
PGMach	PGM	subst:pl:loc:m3
PG	PG	subst:sg.pl:nom.gen.dat.acc.inst.loc.voc:n:ncol
PG	PG	subst:sg.pl:nom.gen.dat.acc.inst.loc.voc:f
PFRONy	PFRON	subst:pl:nom.acc.voc:m3
PFRONu	PFRON	subst:sg:gen:m3
PFRON	PFRON	subst:sg:nom.acc:m3
PFRONów	PFRON	subst:pl:gen:m3
PFRONowi	PFRON	subst:sg:dat:m3
PFRONom	PFRON	subst:pl:dat:m3
PFRONie	PFRON	subst:sg:voc:m3
PFRONie	PFRON	subst:sg:loc:m3
PFRONem	PFRON	subst:sg:inst:m3
PFRONami	PFRON	subst:pl:inst:m3
PFRONach	PFRON	subst:pl:loc:m3
PESELu	PESEL	subst:sg:voc:m3
PESELu	PESEL	subst:sg:loc:m3
PESELu	PESEL	subst:sg:gen:m3
PESEL	PESEL	subst:sg:nom.acc:m3
PESELowi	PESEL	subst:sg:dat:m3
PESELom	PESEL	subst:pl:dat:m3
PESELi	PESEL	subst:pl:gen:m3
PESELe	PESEL	subst:pl:nom.acc.voc:m3
PESELem	PESEL	subst:sg:inst:m3
PESELami	PESEL	subst:pl:inst:m3
PESELach	PESEL	subst:pl:loc:m3
PEN	PEN	subst:sg.pl:nom.gen.dat.acc.inst.loc.voc:m3
PeKaO	PeKaO	subst:sg.pl:nom.gen.dat.acc.inst.loc.voc:n:ncol
PeKaO	PeKaO	subst:sg.pl:nom.gen.dat.acc.inst.loc.voc:f
PDT	PDT	subst:sg.pl:nom.gen.dat.acc.inst.loc.voc:m3
PDSy	PDS	subst:pl:nom.acc.voc:m3
PDSu	PDS	subst:sg:gen:m3
PDS	PDS	subst:sg.pl:nom.gen.dat.acc.inst.loc.voc:f
PDS	PDS	subst:sg:nom.acc:m3
PDSów	PDS	subst:pl:gen:m3
PDSowi	PDS	subst:sg:dat:m3
PDSom	PDS	subst:pl:dat:m3
PDSie	PDS	subst:sg:voc:m3
PDSie	PDS	subst:sg:loc:m3
PDSem	PDS	subst:sg:inst:m3
PDSami	PDS	subst:pl:inst:m3
PDSach	PDS	subst:pl:loc:m3
PCW	PCW	subst:sg.pl:nom.gen.dat.acc.inst.loc.voc:n:ncol
PCW	PCW	subst:sg.pl:nom.gen.dat.acc.inst.loc.voc:m3
PCV	PCV	subst:sg.pl:nom.gen.dat.acc.inst.loc.voc:n:ncol
PCV	PCV	subst:sg.pl:nom.gen.dat.acc.inst.loc.voc:m3
PCR	PCR	subst:sg.pl:nom.gen.dat.acc.inst.loc.voc:n:ncol
PCR	PCR	subst:sg.pl:nom.gen.dat.acc.inst.loc.voc:f
PCK	PCK	subst:sg.pl:nom.gen.dat.acc.inst.loc.voc:n:ncol
PCK	PCK	subst:sg.pl:nom.gen.dat.acc.inst.loc.voc:m3
PCI	PCI	subst:sg.pl:nom.gen.dat.acc.inst.loc.voc:m3
PC	PC	subst:sg.pl:nom.gen.dat.acc.inst.loc.voc:n:ncol
PC	PC	subst:sg.pl:nom.gen.dat.acc.inst.loc.voc:m3
PBSy	PBS	subst:pl:nom.acc.voc:m3
PBSu	PBS	subst:sg:gen:m3
PBS	PBS	subst:sg.pl:nom.gen.dat.acc.inst.loc.voc:f
PBS	PBS	subst:sg:nom.acc:m3
PBSów	PBS	subst:pl:gen:m3
PBSowi	PBS	subst:sg:dat:m3
PBSom	PBS	subst:pl:dat:m3
PBSie	PBS	subst:sg:voc:m3
PBSie	PBS	subst:sg:loc:m3
PBSem	PBS	subst:sg:inst:m3
PBSami	PBS	subst:pl:inst:m3
PBSach	PBS	subst:pl:loc:m3
PBRze	PBR	subst:sg:voc:m3
PBRze	PBR	subst:sg:loc:m3
PBRy	PBR	subst:pl:nom.acc.voc:m3
PBRu	PBR	subst:sg:gen:m3
PBR	PBR	subst:sg:nom.acc:m3
PBRów	PBR	subst:pl:gen:m3
PBRowi	PBR	subst:sg:dat:m3
PBRom	PBR	subst:pl:dat:m3
PBRem	PBR	subst:sg:inst:m3
PBRami	PBR	subst:pl:inst:m3
PBRach	PBR	subst:pl:loc:m3
PBKSy	PBKS	subst:pl:nom.acc.voc:m3
PBKSu	PBKS	subst:sg:gen:m3
PBKS	PBKS	subst:sg:nom.acc:m3
PBKSów	PBKS	subst:pl:gen:m3
PBKSowi	PBKS	subst:sg:dat:m3
PBKSom	PBKS	subst:pl:dat:m3
PBKSie	PBKS	subst:sg:voc:m3
PBKSie	PBKS	subst:sg:loc:m3
PBKSem	PBKS	subst:sg:inst:m3
PBKSami	PBKS	subst:pl:inst:m3
PBKSach	PBKS	subst:pl:loc:m3
PBK	PBK	subst:sg.pl:nom.gen.dat.acc.inst.loc.voc:n:ncol
PBK	PBK	subst:sg.pl:nom.gen.dat.acc.inst.loc.voc:m3
PBH	PBH	subst:sg.pl:nom.gen.dat.acc.inst.loc.voc:n:ncol
PBH	PBH	subst:sg.pl:nom.gen.dat.acc.inst.loc.voc:m3
PBG	PBG	subst:sg.pl:nom.gen.dat.acc.inst.loc.voc:n:ncol
PBG	PBG	subst:sg.pl:nom.gen.dat.acc.inst.loc.voc:m3
PB	PB	subst:sg.pl:nom.gen.dat.acc.inst.loc.voc:n:ncol
PB	PB	subst:sg.pl:nom.gen.dat.acc.inst.loc.voc:m3
PAU	PAU	subst:sg.pl:nom.gen.dat.acc.inst.loc.voc:n:ncol
PAU	PAU	subst:sg.pl:nom.gen.dat.acc.inst.loc.voc:f
PATy	PAT	subst:pl:nom.acc.voc:m3
PATu	PAT	subst:sg:gen:m3
PAT	PAT	subst:sg.pl:nom.gen.dat.acc.inst.loc.voc:f
PAT	PAT	subst:sg:nom.acc:m3
PATów	PAT	subst:pl:gen:m3
PATowi	PAT	subst:sg:dat:m3
PATom	PAT	subst:pl:dat:m3
PATem	PAT	subst:sg:inst:m3
PATami	PAT	subst:pl:inst:m3
PATach	PAT	subst:pl:loc:m3
PAcie	PAT	subst:sg:voc:m3
Pacie	PAT	subst:sg:voc:m3
PAcie	PAT	subst:sg:loc:m3
Pacie	PAT	subst:sg:loc:m3
PAPy	PAP	subst:pl:nom.acc.voc:m3
PAPu	PAP	subst:sg:gen:m3
PAP	PAP	subst:sg.pl:nom.gen.dat.acc.inst.loc.voc:f
PAP	PAP	subst:sg:nom.acc:m3
PAPów	PAP	subst:pl:gen:m3
PAPowi	PAP	subst:sg:dat:m3
PAPom	PAP	subst:pl:dat:m3
PAPie	PAP	subst:sg:voc:m3
PAPie	PAP	subst:sg:loc:m3
PAPem	PAP	subst:sg:inst:m3
PAPami	PAP	subst:pl:inst:m3
PAPach	PAP	subst:pl:loc:m3
PANAMy	PANAM	subst:pl:nom.acc.voc:m3
PANAMu	PANAM	subst:sg:gen:m3
PANAM	PANAM	subst:sg:nom.acc:m3
PANAMów	PANAM	subst:pl:gen:m3
PANAMowi	PANAM	subst:sg:dat:m3
PANAMom	PANAM	subst:pl:dat:m3
PANAMie	PANAM	subst:sg:voc:m3
PANAMie	PANAM	subst:sg:loc:m3
PANAMem	PANAM	subst:sg:inst:m3
PANAMami	PANAM	subst:pl:inst:m3
PANAMach	PANAM	subst:pl:loc:m3
PANy	PAN	subst:pl:nom.acc.voc:m3
PANu	PAN	subst:sg:gen:m3
PAN	PAN	subst:sg.pl:nom.gen.dat.acc.inst.loc.voc:m3
PAN	PAN	subst:sg.pl:nom.gen.dat.acc.inst.loc.voc:f
PAN	PAN	subst:sg:nom.acc:m3
PANów	PAN	subst:pl:gen:m3
PANowi	PAN	subst:sg:dat:m3
PANom	PAN	subst:pl:dat:m3
PANie	PAN	subst:sg:voc:m3
PANie	PAN	subst:sg:loc:m3
PANem	PAN	subst:sg:inst:m3
PANami	PAN	subst:pl:inst:m3
PANach	PAN	subst:pl:loc:m3
PAMy	PAM	subst:pl:nom.acc.voc:m3
PAMu	PAM	subst:sg:gen:m3
PAM	PAM	subst:sg.pl:nom.gen.dat.acc.inst.loc.voc:f
PAM	PAM	subst:sg:nom.acc:m3
PAMów	PAM	subst:pl:gen:m3
PAMowi	PAM	subst:sg:dat:m3
PAMom	PAM	subst:pl:dat:m3
PAMie	PAM	subst:sg:voc:m3
PAMie	PAM	subst:sg:loc:m3
PAMem	PAM	subst:sg:inst:m3
PAMami	PAM	subst:pl:inst:m3
PAMach	PAM	subst:pl:loc:m3
PALu	PAL	subst:sg:voc:m3
PALu	PAL	subst:sg:loc:m3
PALu	PAL	subst:sg:gen:m3
PAL	PAL	subst:sg:nom.acc:m3
PALowi	PAL	subst:sg:dat:m3
PALom	PAL	subst:pl:dat:m3
PALi	PAL	subst:pl:gen:m3
PALe	PAL	subst:pl:nom.acc.voc:m3
PALem	PAL	subst:sg:inst:m3
PALami	PAL	subst:pl:inst:m3
PALach	PAL	subst:pl:loc:m3
PAIu	PAI	subst:sg:voc:m3
PAIu	PAI	subst:sg:loc:m3
PAIu	PAI	subst:sg:gen:m3
PAI	PAI	subst:sg.pl:nom.gen.dat.acc.inst.loc.voc:f
PAI	PAI	subst:sg:nom.acc:m3
PAIowi	PAI	subst:sg:dat:m3
PAIom	PAI	subst:pl:dat:m3
PAIi	PAI	subst:pl:gen:m3
PAIe	PAI	subst:pl:nom.acc.voc:m3
PAIem	PAI	subst:sg:inst:m3
PAIami	PAI	subst:pl:inst:m3
PAIach	PAI	subst:pl:loc:m3
PAHy	PAH	subst:pl:nom.acc.voc:m3
PAHu	PAH	subst:sg:voc:m3
PAHu	PAH	subst:sg:loc:m3
PAHu	PAH	subst:sg:gen:m3
PAH	PAH	subst:sg:nom.acc:m3
PAHów	PAH	subst:pl:gen:m3
PAHowi	PAH	subst:sg:dat:m3
PAHom	PAH	subst:pl:dat:m3
PAHem	PAH	subst:sg:inst:m3
PAHami	PAH	subst:pl:inst:m3
PAHach	PAH	subst:pl:loc:m3
PAGARTy	PAGART	subst:pl:nom.acc.voc:m3
PAGARTu	PAGART	subst:sg:gen:m3
PAGART	PAGART	subst:sg.pl:nom.gen.dat.acc.inst.loc.voc:m3
PAGART	PAGART	subst:sg:nom.acc:m3
PAGARTów	PAGART	subst:pl:gen:m3
PAGARTowi	PAGART	subst:sg:dat:m3
PAGARTom	PAGART	subst:pl:dat:m3
PAGARTem	PAGART	subst:sg:inst:m3
PAGARTami	PAGART	subst:pl:inst:m3
PAGARTach	PAGART	subst:pl:loc:m3
PAGARcie	PAGART	subst:sg:voc:m3
Pagarcie	PAGART	subst:sg:voc:m3
PAGARcie	PAGART	subst:sg:loc:m3
Pagarcie	PAGART	subst:sg:loc:m3
PA	PA	subst:sg.pl:nom.gen.dat.acc.inst.loc.voc:n:ncol
PA	PA	subst:sg.pl:nom.gen.dat.acc.inst.loc.voc:f
OZNy	OZN	subst:pl:nom.acc.voc:m3
OZNu	OZN	subst:sg:gen:m3
OZNów	OZN	subst:pl:gen:m3
OZN	OZN	subst:sg:nom.acc:m3
OZNowi	OZN	subst:sg:dat:m3
OZNom	OZN	subst:pl:dat:m3
OZNie	OZN	subst:sg:voc:m3
OZNie	OZN	subst:sg:loc:m3
OZNem	OZN	subst:sg:inst:m3
OZNami	OZN	subst:pl:inst:m3
OZNach	OZN	subst:pl:loc:m3
OWP	OWP:s2	subst:sg.pl:nom.gen.dat.acc.inst.loc.voc:n:ncol
OWP	OWP:s2	subst:sg.pl:nom.gen.dat.acc.inst.loc.voc:f
OWP	OWP:s1	subst:sg.pl:nom.gen.dat.acc.inst.loc.voc:n:ncol
OWP	OWP:s1	subst:sg.pl:nom.gen.dat.acc.inst.loc.voc:m3
OSP	OSP	subst:sg.pl:nom.gen.dat.acc.inst.loc.voc:n:ncol
OSP	OSP	subst:sg.pl:nom.gen.dat.acc.inst.loc.voc:f
OSH	OSH	subst:sg.pl:nom.gen.dat.acc.inst.loc.voc:n:ncol
OSH	OSH	subst:sg.pl:nom.gen.dat.acc.inst.loc.voc:f
ORWNy	ORWN	subst:pl:nom.acc.voc:m3
ORWNu	ORWN	subst:sg:gen:m3
ORWNów	ORWN	subst:pl:gen:m3
ORWNowi	ORWN	subst:sg:dat:m3
ORWN	ORWN	subst:sg:nom.acc:m3
ORWNom	ORWN	subst:pl:dat:m3
ORWNie	ORWN	subst:sg:voc:m3
ORWNie	ORWN	subst:sg:loc:m3
ORWNem	ORWN	subst:sg:inst:m3
ORWNami	ORWN	subst:pl:inst:m3
ORWNach	ORWN	subst:pl:loc:m3
ORP	ORP	subst:sg.pl:nom.gen.dat.acc.inst.loc.voc:m3
ORMO	ORMO	subst:sg.pl:nom.gen.dat.acc.inst.loc.voc:n:ncol
OPZZy	OPZZ	subst:pl:nom.acc.voc:m3
OPZZu	OPZZ	subst:sg:gen:m3
OPZZów	OPZZ	subst:pl:gen:m3
OPZZowi	OPZZ	subst:sg:dat:m3
OPZZ	OPZZ	subst:sg.pl:nom.gen.dat.acc.inst.loc.voc:n:ncol
OPZZ	OPZZ	subst:sg:nom.acc:m3
OPZZom	OPZZ	subst:pl:dat:m3
OPZZety	OPZZ	subst:pl:nom.acc.voc:m3
OPZZetu	OPZZ	subst:sg:gen:m3
OPZZetów	OPZZ	subst:pl:gen:m3
OPZZetowi	OPZZ	subst:sg:dat:m3
OPZZetom	OPZZ	subst:pl:dat:m3
OPZZetem	OPZZ	subst:sg:inst:m3
OPZZetami	OPZZ	subst:pl:inst:m3
OPZZetach	OPZZ	subst:pl:loc:m3
OPZZem	OPZZ	subst:sg:inst:m3
OPZZecie	OPZZ	subst:sg:voc:m3
OPZZecie	OPZZ	subst:sg:loc:m3
OPZZami	OPZZ	subst:pl:inst:m3
OPZZach	OPZZ	subst:pl:loc:m3
OPECu	OPEC	subst:sg:voc:m3
OPECu	OPEC	subst:sg:loc:m3
OPECów	OPEC	subst:pl:gen:m3
OPECowi	OPEC	subst:sg:dat:m3
OPEC	OPEC	subst:sg.pl:nom.gen.dat.acc.inst.loc.voc:f
OPEC	OPEC	subst:sg:nom.acc:m3
OPECom	OPEC	subst:pl:dat:m3
OPECi	OPEC	subst:pl:nom.acc.voc:m3
OPECiem	OPEC	subst:sg:inst:m3
OPECa	OPEC	subst:sg:gen:m3
OPECami	OPEC	subst:pl:inst:m3
OPECach	OPEC	subst:pl:loc:m3
OPD	OPD	subst:sg.pl:nom.gen.dat.acc.inst.loc.voc:n:ncol
OPD	OPD	subst:sg.pl:nom.gen.dat.acc.inst.loc.voc:f
OPA	OPA	subst:sg.pl:nom.gen.dat.acc.inst.loc.voc:n:ncol
OPA	OPA	subst:sg.pl:nom.gen.dat.acc.inst.loc.voc:f
ONZ	ONZ	subst:sg.pl:nom.gen.dat.acc.inst.loc.voc:m3
ONZ	ONZ	subst:sg:nom.acc:m3
ONZety	ONZ	subst:pl:nom.acc.voc:m3
ONZetu	ONZ	subst:sg:gen:m3
ONZetów	ONZ	subst:pl:gen:m3
ONZetowi	ONZ	subst:sg:dat:m3
ONZetom	ONZ	subst:pl:dat:m3
ONZetem	ONZ	subst:sg:inst:m3
ONZetami	ONZ	subst:pl:inst:m3
ONZetach	ONZ	subst:pl:loc:m3
ONZecie	ONZ	subst:sg:voc:m3
ONZecie	ONZ	subst:sg:loc:m3
ONRze	ONR	subst:sg:voc:m3
ONRze	ONR	subst:sg:loc:m3
ONRy	ONR	subst:pl:nom.acc.voc:m3
ONRu	ONR	subst:sg:gen:m3
ONRów	ONR	subst:pl:gen:m3
ONRowi	ONR	subst:sg:dat:m3
ONR	ONR	subst:sg:nom.acc:m3
ONRom	ONR	subst:pl:dat:m3
ONRem	ONR	subst:sg:inst:m3
ONRami	ONR	subst:pl:inst:m3
ONRach	ONR	subst:pl:loc:m3
ON	ON	subst:sg.pl:nom.gen.dat.acc.inst.loc.voc:m3
OITy	OIT	subst:pl:nom.acc.voc:m3
OITu	OIT	subst:sg:gen:m3
OITów	OIT	subst:pl:gen:m3
OITowi	OIT	subst:sg:dat:m3
OITom	OIT	subst:pl:dat:m3
OIT	OIT	subst:sg.pl:nom.gen.dat.acc.inst.loc.voc:m3
OIT	OIT	subst:sg:nom.acc:m3
OITem	OIT	subst:sg:inst:m3
OITami	OIT	subst:pl:inst:m3
OITach	OIT	subst:pl:loc:m3
OIcie	OIT	subst:sg:voc:m3
Oicie	OIT	subst:sg:voc:m3
OIcie	OIT	subst:sg:loc:m3
Oicie	OIT	subst:sg:loc:m3
OHP	OHP	subst:sg.pl:nom.gen.dat.acc.inst.loc.voc:n:ncol
OHP	OHP	subst:pl:nom.gen.dat.acc.inst.loc.voc:n:pt
OFE	OFE	subst:sg.pl:nom.gen.dat.acc.inst.loc.voc:n:ncol
OFE	OFE	subst:sg.pl:nom.gen.dat.acc.inst.loc.voc:m3
OECD	OECD	subst:sg.pl:nom.gen.dat.acc.inst.loc.voc:n:ncol
OECD	OECD	subst:sg.pl:nom.gen.dat.acc.inst.loc.voc:f
OCRze	OCR	subst:sg:voc:m3
OCRze	OCR	subst:sg:loc:m3
OCRy	OCR	subst:pl:nom.acc.voc:m3
OCRu	OCR	subst:sg:gen:m3
OCRów	OCR	subst:pl:gen:m3
OCRowi	OCR	subst:sg:dat:m3
OCRom	OCR	subst:pl:dat:m3
OCR	OCR	subst:sg:nom.acc:m3
OCRem	OCR	subst:sg:inst:m3
OCRami	OCR	subst:pl:inst:m3
OCRach	OCR	subst:pl:loc:m3
OC	OC	subst:sg.pl:nom.gen.dat.acc.inst.loc.voc:n:ncol
OBOPy	OBOP	subst:pl:nom.acc.voc:m3
OBOPu	OBOP	subst:sg:gen:m3
OBOPów	OBOP	subst:pl:gen:m3
OBOPowi	OBOP	subst:sg:dat:m3
OBOPom	OBOP	subst:pl:dat:m3
OBOP	OBOP	subst:sg:nom.acc:m3
OBOPie	OBOP	subst:sg:voc:m3
OBOPie	OBOP	subst:sg:loc:m3
OBOPem	OBOP	subst:sg:inst:m3
OBOPami	OBOP	subst:pl:inst:m3
OBOPach	OBOP	subst:pl:loc:m3
OB	OB	subst:sg.pl:nom.gen.dat.acc.inst.loc.voc:n:ncol
OB	OB	subst:sg.pl:nom.gen.dat.acc.inst.loc.voc:m3
OAPECu	OAPEC	subst:sg:voc:m3
OAPECu	OAPEC	subst:sg:loc:m3
OAPECów	OAPEC	subst:pl:gen:m3
OAPECowi	OAPEC	subst:sg:dat:m3
OAPECom	OAPEC	subst:pl:dat:m3
OAPEC	OAPEC	subst:sg.pl:nom.gen.dat.acc.inst.loc.voc:f
OAPEC	OAPEC	subst:sg:nom.acc:m3
OAPECi	OAPEC	subst:pl:nom.acc.voc:m3
OAPECiem	OAPEC	subst:sg:inst:m3
OAPECa	OAPEC	subst:sg:gen:m3
OAPECami	OAPEC	subst:pl:inst:m3
OAPECach	OAPEC	subst:pl:loc:m3
NZSy	NZS	subst:pl:nom.acc.voc:m3
NZSu	NZS	subst:sg:gen:m3
NZSów	NZS	subst:pl:gen:m3
NZSowi	NZS	subst:sg:dat:m3
NZSom	NZS	subst:pl:dat:m3
NZS	NZS	subst:sg.pl:nom.gen.dat.acc.inst.loc.voc:n:ncol
NZS	NZS	subst:sg:nom.acc:m3
NZSie	NZS	subst:sg:voc:m3
NZSie	NZS	subst:sg:loc:m3
NZSem	NZS	subst:sg:inst:m3
NZSami	NZS	subst:pl:inst:m3
NZSach	NZS	subst:pl:loc:m3
NZ	NZ	subst:sg.pl:nom.gen.dat.acc.inst.loc.voc:m3
NZ	NZ	subst:sg.pl:nom.gen.dat.acc.inst.loc.voc:f
NWZA	NWZA	subst:sg.pl:nom.gen.dat.acc.inst.loc.voc:n:ncol
NW	NW	subst:sg.pl:nom.gen.dat.acc.inst.loc.voc:n:ncol
NSZZ	NSZZ	subst:sg.pl:nom.gen.dat.acc.inst.loc.voc:m3
NSZy	NSZ	subst:pl:nom.acc.voc:m3
NSZu	NSZ	subst:sg:gen:m3
NSZów	NSZ	subst:pl:gen:m3
NSZowi	NSZ	subst:sg:dat:m3
NSZom	NSZ	subst:pl:dat:m3
NSZ	NSZ	subst:sg:nom.acc:m3
NSZety	NSZ	subst:pl:nom.acc.voc:m3
NSZetu	NSZ	subst:sg:gen:m3
NSZetów	NSZ	subst:pl:gen:m3
NSZetowi	NSZ	subst:sg:dat:m3
NSZetom	NSZ	subst:pl:dat:m3
NSZetem	NSZ	subst:sg:inst:m3
NSZetami	NSZ	subst:pl:inst:m3
NSZetach	NSZ	subst:pl:loc:m3
NSZem	NSZ	subst:sg:inst:m3
NSZecie	NSZ	subst:sg:voc:m3
NSZecie	NSZ	subst:sg:loc:m3
NSZami	NSZ	subst:pl:inst:m3
NSZach	NSZ	subst:pl:loc:m3
NSDAP	NSDAP	subst:sg.pl:nom.gen.dat.acc.inst.loc.voc:n:ncol
NSDAP	NSDAP	subst:sg.pl:nom.gen.dat.acc.inst.loc.voc:f
NSA	NSA	subst:sg.pl:nom.gen.dat.acc.inst.loc.voc:n:ncol
NSA	NSA	subst:sg.pl:nom.gen.dat.acc.inst.loc.voc:m3
NRFy	NRF	subst:pl:nom.acc.voc:m3
NRFu	NRF	subst:sg:gen:m3
NRFów	NRF	subst:pl:gen:m3
NRFowi	NRF	subst:sg:dat:m3
NRFom	NRF	subst:pl:dat:m3
NRF	NRF	subst:sg.pl:nom.gen.dat.acc.inst.loc.voc:f
NRF	NRF	subst:sg:nom.acc:m3
NRFie	NRF	subst:sg:voc:m3
NRFie	NRF	subst:sg:loc:m3
NRFem	NRF	subst:sg:inst:m3
NRFami	NRF	subst:pl:inst:m3
NRFach	NRF	subst:pl:loc:m3
NRD	NRD	subst:sg.pl:nom.gen.dat.acc.inst.loc.voc:n:ncol
NRD	NRD	subst:sg.pl:nom.gen.dat.acc.inst.loc.voc:f
NRA	NRA	subst:sg.pl:nom.gen.dat.acc.inst.loc.voc:f
NPD	NPD	subst:sg.pl:nom.gen.dat.acc.inst.loc.voc:n:ncol
NPD	NPD	subst:sg.pl:nom.gen.dat.acc.inst.loc.voc:f
NOTy	NOT	subst:pl:nom.acc.voc:m3
NOTu	NOT	subst:sg:gen:m3
NOTów	NOT	subst:pl:gen:m3
NOTowi	NOT	subst:sg:dat:m3
NOTom	NOT	subst:pl:dat:m3
NOT	NOT	subst:sg:nom.acc:m3
NOTem	NOT	subst:sg:inst:m3
NOTami	NOT	subst:pl:inst:m3
NOTach	NOT	subst:pl:loc:m3
NOcie	NOT	subst:sg:voc:m3
Nocie	NOT	subst:sg:voc:m3
NOcie	NOT	subst:sg:loc:m3
Nocie	NOT	subst:sg:loc:m3
NMT	NMT	subst:sg.pl:nom.gen.dat.acc.inst.loc.voc:m3
NKWD	NKWD	subst:sg.pl:nom.gen.dat.acc.inst.loc.voc:n:ncol
NKOlu	NKOl	subst:sg:voc:m3
NKOlu	NKOl	subst:sg:loc:m3
NKOlu	NKOl	subst:sg:gen:m3
NKOlowi	NKOl	subst:sg:dat:m3
NKOlom	NKOl	subst:pl:dat:m3
NKOl	NKOl	subst:sg:nom.acc:m3
NKOli	NKOl	subst:pl:gen:m3
NKOle	NKOl	subst:pl:nom.acc.voc:m3
NKOlem	NKOl	subst:sg:inst:m3
NKOlami	NKOl	subst:pl:inst:m3
NKOlach	NKOl	subst:pl:loc:m3
NIPy	NIP	subst:pl:nom.acc.voc:m3
NIPu	NIP	subst:sg:gen:m3
NIPów	NIP	subst:pl:gen:m3
NIPowi	NIP	subst:sg:dat:m3
NIPom	NIP	subst:pl:dat:m3
NIP	NIP	subst:sg.pl:nom.gen.dat.acc.inst.loc.voc:m3
NIP	NIP	subst:sg:nom.acc:m3
NIPie	NIP	subst:sg:voc:m3
NIPie	NIP	subst:sg:loc:m3
NIPem	NIP	subst:sg:inst:m3
NIPami	NIP	subst:pl:inst:m3
NIPach	NIP	subst:pl:loc:m3
NIKu	NIK	subst:sg:voc:m3
NIKu	NIK	subst:sg:loc:m3
NIKu	NIK	subst:sg:gen:m3
NIKów	NIK	subst:pl:gen:m3
NIKowi	NIK	subst:sg:dat:m3
NIKom	NIK	subst:pl:dat:m3
NIK	NIK	subst:sg.pl:nom.gen.dat.acc.inst.loc.voc:m3
NIK	NIK	subst:sg:nom.acc:m3
NIKi	NIK	subst:pl:nom.acc.voc:m3
NIKiem	NIK	subst:sg:inst:m3
NIKami	NIK	subst:pl:inst:m3
NIKach	NIK	subst:pl:loc:m3
NHLu	NHL	subst:sg:voc:m3
NHLu	NHL	subst:sg:loc:m3
NHLu	NHL	subst:sg:gen:m3
NHLowi	NHL	subst:sg:dat:m3
NHLom	NHL	subst:pl:dat:m3
NHL	NHL	subst:sg:nom.acc:m3
NHLi	NHL	subst:pl:gen:m3
NHLe	NHL	subst:pl:nom.acc.voc:m3
NHLem	NHL	subst:sg:inst:m3
NHLami	NHL	subst:pl:inst:m3
NHLach	NHL	subst:pl:loc:m3
NFI	NFI	subst:sg.pl:nom.gen.dat.acc.inst.loc.voc:n:ncol
NFI	NFI	subst:sg.pl:nom.gen.dat.acc.inst.loc.voc:m3
NEPy	NEP	subst:pl:nom.acc.voc:m3
NEPu	NEP	subst:sg:gen:m3
NEPów	NEP	subst:pl:gen:m3
NEPowi	NEP	subst:sg:dat:m3
NEPom	NEP	subst:pl:dat:m3
NEP	NEP	subst:sg:nom.acc:m3
NEPie	NEP	subst:sg:voc:m3
NEPie	NEP	subst:sg:loc:m3
NEPem	NEP	subst:sg:inst:m3
NEPami	NEP	subst:pl:inst:m3
NEPach	NEP	subst:pl:loc:m3
NECu	NEC	subst:sg:voc:m3
NECu	NEC	subst:sg:loc:m3
NECów	NEC	subst:pl:gen:m3
NECowi	NEC	subst:sg:dat:m3
NECom	NEC	subst:pl:dat:m3
NEC	NEC	subst:sg:nom.acc:m3
NECi	NEC	subst:pl:nom.acc.voc:m3
NECiem	NEC	subst:sg:inst:m3
NECa	NEC	subst:sg:gen:m3
NECami	NEC	subst:pl:inst:m3
NECach	NEC	subst:pl:loc:m3
ND	ND	subst:sg.pl:nom.gen.dat.acc.inst.loc.voc:n:ncol
ND	ND	subst:sg.pl:nom.gen.dat.acc.inst.loc.voc:f
NCL	NCL	subst:sg.pl:nom.gen.dat.acc.inst.loc.voc:m3
NCL	NCL	subst:sg.pl:nom.gen.dat.acc.inst.loc.voc:f
NBP	NBP	subst:sg.pl:nom.gen.dat.acc.inst.loc.voc:n:ncol
NBP	NBP	subst:sg.pl:nom.gen.dat.acc.inst.loc.voc:m3
NBC	NBC	subst:sg.pl:nom.gen.dat.acc.inst.loc.voc:n:ncol
NBA	NBA	subst:sg.pl:nom.gen.dat.acc.inst.loc.voc:n:ncol
NATO	NATO	subst:sg.pl:nom.gen.dat.acc.inst.loc.voc:n:ncol
NATO	NATO	subst:sg.pl:nom.gen.dat.acc.inst.loc.voc:f
NASKu	NASK	subst:sg:voc:m3
NASKu	NASK	subst:sg:loc:m3
NASKu	NASK	subst:sg:gen:m3
NASKów	NASK	subst:pl:gen:m3
NASKowi	NASK	subst:sg:dat:m3
NASKom	NASK	subst:pl:dat:m3
NASK	NASK	subst:sg:nom.acc:m3
NASKi	NASK	subst:pl:nom.acc.voc:m3
NASKiem	NASK	subst:sg:inst:m3
NASKami	NASK	subst:pl:inst:m3
NASKach	NASK	subst:pl:loc:m3
NASy	NASA	subst:sg:gen:f
NASy	NASA	subst:pl:nom.acc.voc:f
NASo	NASA	subst:sg:voc:f
NASom	NASA	subst:pl:dat:f
NAS	NASA	subst:pl:gen:f
NASie	NASA	subst:sg:dat.loc:f
NASę	NASA	subst:sg:acc:f
NASą	NASA	subst:sg:inst:f
NASA	NASA	subst:sg.pl:nom.gen.dat.acc.inst.loc.voc:f
NASA	NASA	subst:sg:nom:f
NASami	NASA	subst:pl:inst:f
NASach	NASA	subst:pl:loc:f
NAPy	NAP	subst:pl:nom.acc.voc:m3
NAPu	NAP	subst:sg:gen:m3
NAPów	NAP	subst:pl:gen:m3
NAPowi	NAP	subst:sg:dat:m3
NAPom	NAP	subst:pl:dat:m3
NAP	NAP	subst:sg.pl:nom.gen.dat.acc.inst.loc.voc:f
NAP	NAP	subst:sg:nom.acc:m3
NAPie	NAP	subst:sg:voc:m3
NAPie	NAP	subst:sg:loc:m3
NAPem	NAP	subst:sg:inst:m3
NAPami	NAP	subst:pl:inst:m3
NAPach	NAP	subst:pl:loc:m3
NAFTy	NAFTA	subst:sg:gen:f
NAFTy	NAFTA	subst:pl:nom.acc.voc:f
NAFTo	NAFTA	subst:sg:voc:f
NAFTom	NAFTA	subst:pl:dat:f
NAFT	NAFTA	subst:pl:gen:f
NAFTę	NAFTA	subst:sg:acc:f
NAFTą	NAFTA	subst:sg:inst:f
NAFTA	NAFTA	subst:sg.pl:nom.gen.dat.acc.inst.loc.voc:f
NAFTA	NAFTA	subst:sg:nom:f
NAFTami	NAFTA	subst:pl:inst:f
NAFTach	NAFTA	subst:pl:loc:f
NAFcie	NAFTA	subst:sg:dat.loc:f
MZK	MZK	subst:sg.pl:nom.gen.dat.acc.inst.loc.voc:n:ncol
MZK	MZK	subst:sg.pl:nom.gen.dat.acc.inst.loc.voc:m3
MZ	MZ	subst:sg.pl:nom.gen.dat.acc.inst.loc.voc:n:ncol
MZ	MZ	subst:sg:nom.acc:m3
MZety	MZ	subst:pl:nom.acc.voc:m3
MZetu	MZ	subst:sg:gen:m3
MZetów	MZ	subst:pl:gen:m3
MZetowi	MZ	subst:sg:dat:m3
MZetom	MZ	subst:pl:dat:m3
MZetem	MZ	subst:sg:inst:m3
MZetami	MZ	subst:pl:inst:m3
MZetach	MZ	subst:pl:loc:m3
MZecie	MZ	subst:sg:voc:m3
MZecie	MZ	subst:sg:loc:m3
MWGzZy	MWGzZ	subst:pl:nom.acc.voc:m3
MWGzZu	MWGzZ	subst:sg:gen:m3
MWGzZów	MWGzZ	subst:pl:gen:m3
MWGzZowi	MWGzZ	subst:sg:dat:m3
MWGzZom	MWGzZ	subst:pl:dat:m3
MWGzZ	MWGzZ	subst:sg.pl:nom.gen.dat.acc.inst.loc.voc:n:ncol
MWGzZ	MWGzZ	subst:sg:nom.acc:m3
MWGzZety	MWGzZ	subst:pl:nom.acc.voc:m3
MWGzZetu	MWGzZ	subst:sg:gen:m3
MWGzZetów	MWGzZ	subst:pl:gen:m3
MWGzZetowi	MWGzZ	subst:sg:dat:m3
MWGzZetom	MWGzZ	subst:pl:dat:m3
MWGzZetem	MWGzZ	subst:sg:inst:m3
MWGzZetami	MWGzZ	subst:pl:inst:m3
MWGzZetach	MWGzZ	subst:pl:loc:m3
MWGzZem	MWGzZ	subst:sg:inst:m3
MWGzZecie	MWGzZ	subst:sg:voc:m3
MWGzZecie	MWGzZ	subst:sg:loc:m3
MWGzZami	MWGzZ	subst:pl:inst:m3
MWGzZach	MWGzZ	subst:pl:loc:m3
MW	MW	subst:sg.pl:nom.gen.dat.acc.inst.loc.voc:f
MTV	MTV	subst:sg.pl:nom.gen.dat.acc.inst.loc.voc:f
MTSy	MTS	subst:pl:nom.acc.voc:m3
MTSu	MTS	subst:sg:gen:m3
MTSów	MTS	subst:pl:gen:m3
MTSowi	MTS	subst:sg:dat:m3
MTSom	MTS	subst:pl:dat:m3
MTS	MTS	subst:sg:nom.acc:m3
MTSie	MTS	subst:sg:voc:m3
MTSie	MTS	subst:sg:loc:m3
MTSem	MTS	subst:sg:inst:m3
MTSami	MTS	subst:pl:inst:m3
MTSach	MTS	subst:pl:loc:m3
MTP	MTP	subst:pl:nom.gen.dat.acc.inst.loc.voc:n:pt
MT	MT	subst:sg.pl:nom.gen.dat.acc.inst.loc.voc:n:ncol
MŚ	MŚ:s2	subst:pl:nom.gen.dat.acc.inst.loc.voc:n:pt
MŚu	MŚ:s1	subst:sg:voc:m3
MŚu	MŚ:s1	subst:sg:loc:m3
MŚu	MŚ:s1	subst:sg:gen:m3
MŚów	MŚ:s1	subst:pl:gen:m3
MŚowi	MŚ:s1	subst:sg:dat:m3
MŚom	MŚ:s1	subst:pl:dat:m3
MŚ	MŚ:s1	subst:sg:nom.acc:m3
MŚe	MŚ:s1	subst:pl:nom.acc.voc:m3
MŚem	MŚ:s1	subst:sg:inst:m3
MŚami	MŚ:s1	subst:pl:inst:m3
MŚach	MŚ:s1	subst:pl:loc:m3
MSZy	MSZ	subst:pl:nom.acc.voc:m3
MSZu	MSZ	subst:sg:gen:m3
MSZów	MSZ	subst:pl:gen:m3
MSZowi	MSZ	subst:sg:dat:m3
MSZom	MSZ	subst:pl:dat:m3
MSZ	MSZ	subst:sg.pl:nom.gen.dat.acc.inst.loc.voc:m3
MSZ	MSZ	subst:sg:nom.acc:m3
MSZety	MSZ	subst:pl:nom.acc.voc:m3
MSZetu	MSZ	subst:sg:gen:m3
MSZetów	MSZ	subst:pl:gen:m3
MSZetowi	MSZ	subst:sg:dat:m3
MSZetom	MSZ	subst:pl:dat:m3
MSZetem	MSZ	subst:sg:inst:m3
MSZetami	MSZ	subst:pl:inst:m3
MSZetach	MSZ	subst:pl:loc:m3
MSZem	MSZ	subst:sg:inst:m3
MSZecie	MSZ	subst:sg:voc:m3
MSZecie	MSZ	subst:sg:loc:m3
MSZami	MSZ	subst:pl:inst:m3
MSZach	MSZ	subst:pl:loc:m3
MSWiA	MSWiA	subst:sg.pl:nom.gen.dat.acc.inst.loc.voc:n:ncol
MSW	MSW	subst:sg.pl:nom.gen.dat.acc.inst.loc.voc:n:ncol
MSW	MSW	subst:sg.pl:nom.gen.dat.acc.inst.loc.voc:m3
MSP	MSP	subst:sg.pl:nom.gen.dat.acc.inst.loc.voc:n:ncol
MSDOSy	MSDOS	subst:pl:nom.acc.voc:m3
MSDOSu	MSDOS	subst:sg:gen:m3
MSDOSów	MSDOS	subst:pl:gen:m3
MSDOSowi	MSDOS	subst:sg:dat:m3
MSDOSom	MSDOS	subst:pl:dat:m3
MSDOS	MSDOS	subst:sg:nom.acc:m3
MSDOSie	MSDOS	subst:sg:voc:m3
MSDOSie	MSDOS	subst:sg:loc:m3
MSDOSem	MSDOS	subst:sg:inst:m3
MSDOSami	MSDOS	subst:pl:inst:m3
MSDOSach	MSDOS	subst:pl:loc:m3
MSy	MS	subst:pl:nom.acc.voc:m3
MSu	MS	subst:sg:gen:m3
MSów	MS	subst:pl:gen:m3
MSowi	MS	subst:sg:dat:m3
MSom	MS	subst:pl:dat:m3
MS	MS	subst:sg.pl:nom.gen.dat.acc.inst.loc.voc:n:ncol
MS	MS	subst:sg:nom.acc:m3
MSie	MS	subst:sg:voc:m3
MSie	MS	subst:sg:loc:m3
MSem	MS	subst:sg:inst:m3
MSami	MS	subst:pl:inst:m3
MSach	MS	subst:pl:loc:m3
MRRze	MRR	subst:sg:voc:m3
MRRze	MRR	subst:sg:loc:m3
MRRy	MRR	subst:pl:nom.acc.voc:m3
MRRu	MRR	subst:sg:gen:m3
MRRów	MRR	subst:pl:gen:m3
MRRowi	MRR	subst:sg:dat:m3
MRRom	MRR	subst:pl:dat:m3
MRR	MRR	subst:sg.pl:nom.gen.dat.acc.inst.loc.voc:n:ncol
MRR	MRR	subst:sg:nom.acc:m3
MRRem	MRR	subst:sg:inst:m3
MRRami	MRR	subst:pl:inst:m3
MRRach	MRR	subst:pl:loc:m3
MRiRW	MRiRW	subst:sg.pl:nom.gen.dat.acc.inst.loc.voc:n:ncol
MPW	MPW	subst:sg.pl:nom.gen.dat.acc.inst.loc.voc:n:ncol
MP	MP:s2	subst:sg.pl:nom.gen.dat.acc.inst.loc.voc:n:ncol
MP	MP:s1	subst:sg.pl:nom.gen.dat.acc.inst.loc.voc:m3
MPO	MPO	subst:sg.pl:nom.gen.dat.acc.inst.loc.voc:n:ncol
MPK	MPK	subst:sg.pl:nom.gen.dat.acc.inst.loc.voc:n:ncol
MPiPSy	MPiPS	subst:pl:nom.acc.voc:m3
MPiPSu	MPiPS	subst:sg:gen:m3
MPiPSów	MPiPS	subst:pl:gen:m3
MPiPSowi	MPiPS	subst:sg:dat:m3
MPiPSom	MPiPS	subst:pl:dat:m3
MPiPS	MPiPS	subst:sg.pl:nom.gen.dat.acc.inst.loc.voc:n:ncol
MPiPS	MPiPS	subst:sg:nom.acc:m3
MPiPSie	MPiPS	subst:sg:voc:m3
MPiPSie	MPiPS	subst:sg:loc:m3
MPiPSem	MPiPS	subst:sg:inst:m3
MPiPSami	MPiPS	subst:pl:inst:m3
MPiPSach	MPiPS	subst:pl:loc:m3
MPiKu	MPiK	subst:sg:voc:m3
MPiKu	MPiK	subst:sg:loc:m3
MPiKu	MPiK	subst:sg:gen:m3
MPiKów	MPiK	subst:pl:gen:m3
MPiKowi	MPiK	subst:sg:dat:m3
MPiKom	MPiK	subst:pl:dat:m3
MPiK	MPiK	subst:sg:nom.acc:m3
MPiKi	MPiK	subst:pl:nom.acc.voc:m3
MPiKiem	MPiK	subst:sg:inst:m3
MPiKami	MPiK	subst:pl:inst:m3
MPiKach	MPiK	subst:pl:loc:m3
MOSiRze	MOSiR	subst:sg:voc:m3
MOSiRze	MOSiR	subst:sg:loc:m3
MOSiRy	MOSiR	subst:pl:nom.acc.voc:m3
MOSiRu	MOSiR	subst:sg:gen:m3
MOSiRów	MOSiR	subst:pl:gen:m3
MOSiRowi	MOSiR	subst:sg:dat:m3
MOSiRom	MOSiR	subst:pl:dat:m3
MOSiR	MOSiR	subst:sg:nom.acc:m3
MOSiRem	MOSiR	subst:sg:inst:m3
MOSiRami	MOSiR	subst:pl:inst:m3
MOSiRach	MOSiR	subst:pl:loc:m3
MOPy	MOP	subst:pl:nom.acc.voc:m3
MOPu	MOP	subst:sg:gen:m3
MOPów	MOP	subst:pl:gen:m3
MOPowi	MOP	subst:sg:dat:m3
MOPom	MOP	subst:pl:dat:m3
MOP	MOP	subst:sg.pl:nom.gen.dat.acc.inst.loc.voc:f
MOP	MOP	subst:sg:nom.acc:m3
MOPie	MOP	subst:sg:voc:m3
MOPie	MOP	subst:sg:loc:m3
MOPem	MOP	subst:sg:inst:m3
MOPami	MOP	subst:pl:inst:m3
MOPach	MOP	subst:pl:loc:m3
MONy	MON	subst:pl:nom.acc.voc:m3
MONu	MON	subst:sg:gen:m3
MONów	MON	subst:pl:gen:m3
MONowi	MON	subst:sg:dat:m3
MONom	MON	subst:pl:dat:m3
MON	MON	subst:sg:nom.acc:m3
MONie	MON	subst:sg:voc:m3
MONie	MON	subst:sg:loc:m3
MONem	MON	subst:sg:inst:m3
MONami	MON	subst:pl:inst:m3
MONach	MON	subst:pl:loc:m3
MOKu	MOK	subst:sg:voc:m3
MOKu	MOK	subst:sg:loc:m3
MOKu	MOK	subst:sg:gen:m3
MOKów	MOK	subst:pl:gen:m3
MOKowi	MOK	subst:sg:dat:m3
MOKom	MOK	subst:pl:dat:m3
MOK	MOK	subst:sg:nom.acc:m3
MOKi	MOK	subst:pl:nom.acc.voc:m3
MOKiem	MOK	subst:sg:inst:m3
MOKami	MOK	subst:pl:inst:m3
MOKach	MOK	subst:pl:loc:m3
MO	MO	subst:sg.pl:nom.gen.dat.acc.inst.loc.voc:n:ncol
MO	MO	subst:sg.pl:nom.gen.dat.acc.inst.loc.voc:f
MNy	MN	subst:pl:nom.acc.voc:m3
MNu	MN	subst:sg:gen:m3
MNów	MN	subst:pl:gen:m3
MNowi	MN	subst:sg:dat:m3
MNom	MN	subst:pl:dat:m3
MN	MN	subst:sg.pl:nom.gen.dat.acc.inst.loc.voc:n:ncol
MN	MN	subst:sg:nom.acc:m3
MNie	MN	subst:sg:voc:m3
MNie	MN	subst:sg:loc:m3
MNem	MN	subst:sg:inst:m3
MNami	MN	subst:pl:inst:m3
MNach	MN	subst:pl:loc:m3
MKSy	MKS	subst:pl:nom.acc.voc:m3
MKSu	MKS	subst:sg:gen:m3
MKSów	MKS	subst:pl:gen:m3
MKSowi	MKS	subst:sg:dat:m3
MKSom	MKS	subst:pl:dat:m3
MKS	MKS	subst:sg:nom.acc:m3
MKSie	MKS	subst:sg:voc:m3
MKSie	MKS	subst:sg:loc:m3
MKSem	MKS	subst:sg:inst:m3
MKSami	MKS	subst:pl:inst:m3
MKSach	MKS	subst:pl:loc:m3
MKOlu	MKOl	subst:sg:voc:m3
MKOlu	MKOl	subst:sg:loc:m3
MKOlu	MKOl	subst:sg:gen:m3
MKOlowi	MKOl	subst:sg:dat:m3
MKOlom	MKOl	subst:pl:dat:m3
MKOl	MKOl	subst:sg.pl:nom.gen.dat.acc.inst.loc.voc:m3
MKOl	MKOl	subst:sg:nom.acc:m3
MKOli	MKOl	subst:pl:gen:m3
MKOlem	MKOl	subst:sg:inst:m3
MKOle	MKOl	subst:pl:nom.acc.voc:m3
MKOlami	MKOl	subst:pl:inst:m3
MKOlach	MKOl	subst:pl:loc:m3
MKiDNy	MKiDN	subst:pl:nom.acc.voc:m3
MKiDNu	MKiDN	subst:sg:gen:m3
MKiDNów	MKiDN	subst:pl:gen:m3
MKiDNowi	MKiDN	subst:sg:dat:m3
MKiDNom	MKiDN	subst:pl:dat:m3
MKiDN	MKiDN	subst:sg:nom.acc:m3
MKiDNie	MKiDN	subst:sg:voc:m3
MKiDNie	MKiDN	subst:sg:loc:m3
MKiDNem	MKiDN	subst:sg:inst:m3
MKiDNami	MKiDN	subst:pl:inst:m3
MKiDNach	MKiDN	subst:pl:loc:m3
MGMy	MGM:s2	subst:pl:nom.acc.voc:m3
MGMu	MGM:s2	subst:sg:gen:m3
MGMów	MGM:s2	subst:pl:gen:m3
MGMowi	MGM:s2	subst:sg:dat:m3
MGMom	MGM:s2	subst:pl:dat:m3
MGM	MGM:s2	subst:sg.pl:nom.gen.dat.acc.inst.loc.voc:f
MGM	MGM:s2	subst:sg:nom.acc:m3
MGMie	MGM:s2	subst:sg:voc:m3
MGMie	MGM:s2	subst:sg:loc:m3
MGMem	MGM:s2	subst:sg:inst:m3
MGMami	MGM:s2	subst:pl:inst:m3
MGMach	MGM:s2	subst:pl:loc:m3
MGMy	MGM:s1	subst:pl:nom.acc.voc:m3
MGMu	MGM:s1	subst:sg:gen:m3
MGMów	MGM:s1	subst:pl:gen:m3
MGMowi	MGM:s1	subst:sg:dat:m3
MGMom	MGM:s1	subst:pl:dat:m3
MGM	MGM:s1	subst:sg:nom.acc:m3
MGMie	MGM:s1	subst:sg:voc:m3
MGMie	MGM:s1	subst:sg:loc:m3
MGMem	MGM:s1	subst:sg:inst:m3
MGMami	MGM:s1	subst:pl:inst:m3
MGMach	MGM:s1	subst:pl:loc:m3
MG	MG	subst:sg.pl:nom.gen.dat.acc.inst.loc.voc:n:ncol
MG	MG	subst:sg.pl:nom.gen.dat.acc.inst.loc.voc:m3
MFW	MFW	subst:sg.pl:nom.gen.dat.acc.inst.loc.voc:n:ncol
MFW	MFW	subst:sg.pl:nom.gen.dat.acc.inst.loc.voc:m3
MFy	MF	subst:pl:nom.acc.voc:m3
MFu	MF	subst:sg:gen:m3
MFów	MF	subst:pl:gen:m3
MFowi	MF	subst:sg:dat:m3
MFom	MF	subst:pl:dat:m3
MF	MF	subst:sg:nom.acc:m3
MFie	MF	subst:sg:voc:m3
MFie	MF	subst:sg:loc:m3
MFem	MF	subst:sg:inst:m3
MFami	MF	subst:pl:inst:m3
MFach	MF	subst:pl:loc:m3
MEPy	MEP	subst:pl:nom.acc.voc:m3
MEPu	MEP	subst:sg:gen:m3
MEPów	MEP	subst:pl:gen:m3
MEPowi	MEP	subst:sg:dat:m3
MEPom	MEP	subst:pl:dat:m3
MEP	MEP	subst:sg.pl:nom.gen.dat.acc.inst.loc.voc:f
MEP	MEP	subst:sg:nom.acc:m3
MEPie	MEP	subst:sg:voc:m3
MEPie	MEP	subst:sg:loc:m3
MEPem	MEP	subst:sg:inst:m3
MEPami	MEP	subst:pl:inst:m3
MEPach	MEP	subst:pl:loc:m3
MENy	MENA	subst:sg:gen:f
MENy	MENA	subst:pl:nom.acc.voc:f
MENom	MENA	subst:pl:dat:f
MENo	MENA	subst:sg:voc:f
MEN	MENA	subst:pl:gen:f
MENie	MENA	subst:sg:dat.loc:f
MENę	MENA	subst:sg:acc:f
MENą	MENA	subst:sg:inst:f
MENami	MENA	subst:pl:inst:f
MENA	MENA	subst:sg:nom:f
MENach	MENA	subst:pl:loc:f
MENy	MEN	subst:pl:nom.acc.voc:m3
MENu	MEN	subst:sg:gen:m3
MENów	MEN	subst:pl:gen:m3
MENowi	MEN	subst:sg:dat:m3
MENom	MEN	subst:pl:dat:m3
MEN	MEN	subst:sg:nom.acc:m3
MENie	MEN	subst:sg:voc:m3
MENie	MEN	subst:sg:loc:m3
MENem	MEN	subst:sg:inst:m3
MENami	MEN	subst:pl:inst:m3
MENach	MEN	subst:pl:loc:m3
MDMy	MDM	subst:pl:nom.acc.voc:m3
MDMu	MDM	subst:sg:gen:m3
MDMów	MDM	subst:pl:gen:m3
MDMowi	MDM	subst:sg:dat:m3
MDMom	MDM	subst:pl:dat:m3
MDM	MDM	subst:sg:nom.acc:m3
MDMie	MDM	subst:sg:voc:m3
MDMie	MDM	subst:sg:loc:m3
MDMem	MDM	subst:sg:inst:m3
MDMami	MDM	subst:pl:inst:m3
MDMach	MDM	subst:pl:loc:m3
MDK	MDK	subst:sg.pl:nom.gen.dat.acc.inst.loc.voc:m3
MCK	MCK	subst:sg.pl:nom.gen.dat.acc.inst.loc.voc:m3
MBOiRze	MBOiR	subst:sg:voc:m3
MBOiRze	MBOiR	subst:sg:loc:m3
MBOiRy	MBOiR	subst:pl:nom.acc.voc:m3
MBOiRu	MBOiR	subst:sg:gen:m3
MBOiRów	MBOiR	subst:pl:gen:m3
MBOiRowi	MBOiR	subst:sg:dat:m3
MBOiRom	MBOiR	subst:pl:dat:m3
MBOiR	MBOiR	subst:sg:nom.acc:m3
MBOiRem	MBOiR	subst:sg:inst:m3
MBOiRami	MBOiR	subst:pl:inst:m3
MBOiRach	MBOiR	subst:pl:loc:m3
MBy	MB	subst:pl:nom.acc.voc:m3
MBu	MB	subst:sg:gen:m3
MBów	MB	subst:pl:gen:m3
MBowi	MB	subst:sg:dat:m3
MBom	MB	subst:pl:dat:m3
MB	MB	subst:sg.pl:nom.gen.dat.acc.inst.loc.voc:n:ncol
MB	MB	subst:sg:nom.acc:m3
MBie	MB	subst:sg:voc:m3
MBie	MB	subst:sg:loc:m3
MBem	MB	subst:sg:inst:m3
MBami	MB	subst:pl:inst:m3
MBach	MB	subst:pl:loc:m3
MALu	MAL	subst:sg:voc:m3
MALu	MAL	subst:sg:loc:m3
MALu	MAL	subst:sg:gen:m3
MALowi	MAL	subst:sg:dat:m3
MALom	MAL	subst:pl:dat:m3
MAL	MAL	subst:sg:nom.acc:m3
MALi	MAL	subst:pl:gen:m3
MALem	MAL	subst:sg:inst:m3
MALe	MAL	subst:pl:nom.acc.voc:m3
MALami	MAL	subst:pl:inst:m3
MALach	MAL	subst:pl:loc:m3
ŁKSy	ŁKS	subst:pl:nom.acc.voc:m3
ŁKSu	ŁKS	subst:sg:gen:m3
ŁKSów	ŁKS	subst:pl:gen:m3
ŁKSowi	ŁKS	subst:sg:dat:m3
ŁKSom	ŁKS	subst:pl:dat:m3
ŁKS	ŁKS	subst:sg:nom.acc:m3
ŁKSie	ŁKS	subst:sg:voc:m3
ŁKSie	ŁKS	subst:sg:loc:m3
ŁKSem	ŁKS	subst:sg:inst:m3
ŁKSami	ŁKS	subst:pl:inst:m3
ŁKSach	ŁKS	subst:pl:loc:m3
ŁBRze	ŁBR	subst:sg:voc:m3
ŁBRze	ŁBR	subst:sg:loc:m3
ŁBRy	ŁBR	subst:pl:nom.acc.voc:m3
ŁBRu	ŁBR	subst:sg:gen:m3
ŁBRów	ŁBR	subst:pl:gen:m3
ŁBRowi	ŁBR	subst:sg:dat:m3
ŁBRom	ŁBR	subst:pl:dat:m3
ŁBR	ŁBR	subst:sg:nom.acc:m3
ŁBRem	ŁBR	subst:sg:inst:m3
ŁBRami	ŁBR	subst:pl:inst:m3
ŁBRach	ŁBR	subst:pl:loc:m3
LZSy	LZS	subst:pl:nom.acc.voc:m3
LZSu	LZS	subst:sg:gen:m3
LZSów	LZS	subst:pl:gen:m3
LZSowi	LZS	subst:sg:dat:m3
LZSom	LZS	subst:pl:dat:m3
LZS	LZS	subst:sg:nom.acc:m3
LZS	LZS	subst:pl:nom.gen.dat.acc.inst.loc.voc:n:pt
LZSie	LZS	subst:sg:voc:m3
LZSie	LZS	subst:sg:loc:m3
LZSem	LZS	subst:sg:inst:m3
LZSami	LZS	subst:pl:inst:m3
LZSach	LZS	subst:pl:loc:m3
LZ	LZ	subst:sg.pl:nom.gen.dat.acc.inst.loc.voc:n:ncol
LSD	LSD	subst:sg.pl:nom.gen.dat.acc.inst.loc.voc:n:ncol
LR	LR	subst:sg.pl:nom.gen.dat.acc.inst.loc.voc:m3
LP	LP:s3	subst:sg.pl:nom.gen.dat.acc.inst.loc.voc:n:ncol
LP	LP:s1	subst:pl:nom.gen.dat.acc.inst.loc.voc:n:pt
LPRze	LPR	subst:sg:voc:m3
LPRze	LPR	subst:sg:loc:m3
LPRy	LPR	subst:pl:nom.acc.voc:m3
LPRu	LPR	subst:sg:gen:m3
LPRów	LPR	subst:pl:gen:m3
LPRowi	LPR	subst:sg:dat:m3
LPRom	LPR	subst:pl:dat:m3
LPR	LPR	subst:sg.pl:nom.gen.dat.acc.inst.loc.voc:f
LPR	LPR	subst:sg:nom.acc:m3
LPRem	LPR	subst:sg:inst:m3
LPRami	LPR	subst:pl:inst:m3
LPRach	LPR	subst:pl:loc:m3
LOTy	LOT	subst:pl:nom.acc.voc:m3
LOTu	LOT	subst:sg:gen:m3
LOTów	LOT	subst:pl:gen:m3
LOTowi	LOT	subst:sg:dat:m3
LOTom	LOT	subst:pl:dat:m3
LOT	LOT	subst:sg:nom.acc:m3
LOTem	LOT	subst:sg:inst:m3
LOTami	LOT	subst:pl:inst:m3
LOTach	LOT	subst:pl:loc:m3
LOcie	LOT	subst:sg:voc:m3
Locie	LOT	subst:sg:voc:m3
LOcie	LOT	subst:sg:loc:m3
Locie	LOT	subst:sg:loc:m3
LOPy	LOP	subst:pl:nom.acc.voc:m3
LOPu	LOP	subst:sg:gen:m3
LOPów	LOP	subst:pl:gen:m3
LOPowi	LOP	subst:sg:dat:m3
LOPom	LOP	subst:pl:dat:m3
LOP	LOP	subst:sg.pl:nom.gen.dat.acc.inst.loc.voc:f
LOP	LOP	subst:sg:nom.acc:m3
LOPie	LOP	subst:sg:voc:m3
LOPie	LOP	subst:sg:loc:m3
LOPem	LOP	subst:sg:inst:m3
LOPami	LOP	subst:pl:inst:m3
LOPach	LOP	subst:pl:loc:m3
LOKu	LOK	subst:sg:voc:m3
LOKu	LOK	subst:sg:loc:m3
LOKu	LOK	subst:sg:gen:m3
LOKów	LOK	subst:pl:gen:m3
LOKowi	LOK	subst:sg:dat:m3
LOKom	LOK	subst:pl:dat:m3
LOK	LOK	subst:sg.pl:nom.gen.dat.acc.inst.loc.voc:f
LOK	LOK	subst:sg:nom.acc:m3
LOKi	LOK	subst:pl:nom.acc.voc:m3
LOKiem	LOK	subst:sg:inst:m3
LOKami	LOK	subst:pl:inst:m3
LOKach	LOK	subst:pl:loc:m3
LO	LO	subst:sg.pl:nom.gen.dat.acc.inst.loc.voc:n:ncol
LNy	LN	subst:pl:nom.acc.voc:m3
LNu	LN	subst:sg:gen:m3
LNów	LN	subst:pl:gen:m3
LNowi	LN	subst:sg:dat:m3
LNom	LN	subst:pl:dat:m3
LN	LN	subst:sg.pl:nom.gen.dat.acc.inst.loc.voc:f
LN	LN	subst:sg:nom.acc:m3
LNie	LN	subst:sg:voc:m3
LNie	LN	subst:sg:loc:m3
LNem	LN	subst:sg:inst:m3
LNami	LN	subst:pl:inst:m3
LNach	LN	subst:pl:loc:m3
lkmy	lkm	subst:pl:nom.acc.voc:m3
lkmu	lkm	subst:sg:gen:m3
lkmów	lkm	subst:pl:gen:m3
lkmowi	lkm	subst:sg:dat:m3
lkmom	lkm	subst:pl:dat:m3
lkm	lkm	subst:sg:nom.acc:m3
lkmie	lkm	subst:sg:voc:m3
lkmie	lkm	subst:sg:loc:m3
lkmem	lkm	subst:sg:inst:m3
lkmami	lkm	subst:pl:inst:m3
lkmach	lkm	subst:pl:loc:m3
LH	LH	subst:sg.pl:nom.gen.dat.acc.inst.loc.voc:n:ncol
LETTy	LETTA	subst:sg:gen:f
LETTy	LETTA	subst:pl:nom.acc.voc:f
LETTom	LETTA	subst:pl:dat:f
LETTo	LETTA	subst:sg:voc:f
LETT	LETTA	subst:pl:gen:f
LETTę	LETTA	subst:sg:acc:f
LETTą	LETTA	subst:sg:inst:f
LETTami	LETTA	subst:pl:inst:f
LETTA	LETTA	subst:sg:nom:f
LETTach	LETTA	subst:pl:loc:f
LETcie	LETTA	subst:sg:dat.loc:f
LE	LE	subst:sg.pl:nom.gen.dat.acc.inst.loc.voc:n:ncol
LDLu	LDL	subst:sg:voc:m3
LDLu	LDL	subst:sg:loc:m3
LDLu	LDL	subst:sg:gen:m3
LDLowi	LDL	subst:sg:dat:m3
LDLom	LDL	subst:pl:dat:m3
LDL	LDL	subst:sg:nom.acc:m3
LDLi	LDL	subst:pl:gen:m3
LDLem	LDL	subst:sg:inst:m3
LDLe	LDL	subst:pl:nom.acc.voc:m3
LDLami	LDL	subst:pl:inst:m3
LDLach	LDL	subst:pl:loc:m3
LCD	LCD	subst:sg.pl:nom.gen.dat.acc.inst.loc.voc:n:ncol
LCD	LCD	subst:sg.pl:nom.gen.dat.acc.inst.loc.voc:m3
LC	LC	subst:sg.pl:nom.gen.dat.acc.inst.loc.voc:n:ncol
LANy	LAN	subst:pl:nom.acc.voc:m3
LANu	LAN	subst:sg:gen:m3
LANów	LAN	subst:pl:gen:m3
LANowi	LAN	subst:sg:dat:m3
LANom	LAN	subst:pl:dat:m3
LAN	LAN	subst:sg:nom.acc:m3
LANie	LAN	subst:sg:voc:m3
LANie	LAN	subst:sg:loc:m3
LANem	LAN	subst:sg:inst:m3
LANami	LAN	subst:pl:inst:m3
LANach	LAN	subst:pl:loc:m3
KW	KW:s3	subst:sg.pl:nom.gen.dat.acc.inst.loc.voc:n:ncol
KW	KW:s3	subst:sg.pl:nom.gen.dat.acc.inst.loc.voc:m3
KW	KW:s1	subst:sg.pl:nom.gen.dat.acc.inst.loc.voc:n:ncol
KW	KW:s1	subst:sg.pl:nom.gen.dat.acc.inst.loc.voc:f
KWP	KWP	subst:sg.pl:nom.gen.dat.acc.inst.loc.voc:n:ncol
KWP	KWP	subst:sg.pl:nom.gen.dat.acc.inst.loc.voc:f
KULu	KUL	subst:sg:voc:m3
KULu	KUL	subst:sg:loc:m3
KULu	KUL	subst:sg:gen:m3
KULowi	KUL	subst:sg:dat:m3
KULom	KUL	subst:pl:dat:m3
KUL	KUL	subst:sg:nom.acc:m3
KULi	KUL	subst:pl:gen:m3
KULem	KUL	subst:sg:inst:m3
KULe	KUL	subst:pl:nom.acc.voc:m3
KULami	KUL	subst:pl:inst:m3
KULach	KUL	subst:pl:loc:m3
KSERMy	KSERM	subst:pl:nom.acc.voc:m3
KSERMu	KSERM	subst:sg:gen:m3
KSERMów	KSERM	subst:pl:gen:m3
KSERMowi	KSERM	subst:sg:dat:m3
KSERMom	KSERM	subst:pl:dat:m3
KSERM	KSERM	subst:sg:nom.acc:m3
KSERMie	KSERM	subst:sg:voc:m3
KSERMie	KSERM	subst:sg:loc:m3
KSERMem	KSERM	subst:sg:inst:m3
KSERMami	KSERM	subst:pl:inst:m3
KSERMach	KSERM	subst:pl:loc:m3
KSAPy	KSAP	subst:pl:nom.acc.voc:m3
KSAPu	KSAP	subst:sg:gen:m3
KSAPów	KSAP	subst:pl:gen:m3
KSAPowi	KSAP	subst:sg:dat:m3
KSAPom	KSAP	subst:pl:dat:m3
KSAP	KSAP	subst:sg.pl:nom.gen.dat.acc.inst.loc.voc:f
KSAP	KSAP	subst:sg:nom.acc:m3
KSAPie	KSAP	subst:sg:voc:m3
KSAPie	KSAP	subst:sg:loc:m3
KSAPem	KSAP	subst:sg:inst:m3
KSAPami	KSAP	subst:pl:inst:m3
KSAPach	KSAP	subst:pl:loc:m3
KRUSy	KRUS	subst:pl:nom.acc.voc:m3
KRUSu	KRUS	subst:sg:gen:m3
KRUSów	KRUS	subst:pl:gen:m3
KRUSowi	KRUS	subst:sg:dat:m3
KRUSom	KRUS	subst:pl:dat:m3
KRUS	KRUS	subst:sg.pl:nom.gen.dat.acc.inst.loc.voc:f
KRUS	KRUS	subst:sg:nom.acc:m3
KRUSie	KRUS	subst:sg:voc:m3
KRUSie	KRUS	subst:sg:loc:m3
KRUSem	KRUS	subst:sg:inst:m3
KRUSami	KRUS	subst:pl:inst:m3
KRUSach	KRUS	subst:pl:loc:m3
KRSy	KRS	subst:pl:nom.acc.voc:m3
KRSu	KRS	subst:sg:gen:m3
KRSów	KRS	subst:pl:gen:m3
KRSowi	KRS	subst:sg:dat:m3
KRSom	KRS	subst:pl:dat:m3
KRS	KRS	subst:sg.pl:nom.gen.dat.acc.inst.loc.voc:f
KRS	KRS	subst:sg:nom.acc:m3
KRSie	KRS	subst:sg:voc:m3
KRSie	KRS	subst:sg:loc:m3
KRSem	KRS	subst:sg:inst:m3
KRSami	KRS	subst:pl:inst:m3
KRSach	KRS	subst:pl:loc:m3
KRRiTy	KRRiT	subst:pl:nom.acc.voc:m3
KRRiTu	KRRiT	subst:sg:gen:m3
KRRiTów	KRRiT	subst:pl:gen:m3
KRRiTowi	KRRiT	subst:sg:dat:m3
KRRiTom	KRRiT	subst:pl:dat:m3
KRRiT	KRRiT	subst:sg.pl:nom.gen.dat.acc.inst.loc.voc:f
KRRiT	KRRiT	subst:sg:nom.acc:m3
KRRiTem	KRRiT	subst:sg:inst:m3
KRRiTami	KRRiT	subst:pl:inst:m3
KRRiTach	KRRiT	subst:pl:loc:m3
KRRicie	KRRiT	subst:sg:voc:m3
Krricie	KRRiT	subst:sg:voc:m3
KRRicie	KRRiT	subst:sg:loc:m3
Krricie	KRRiT	subst:sg:loc:m3
KRO	KRO	subst:sg.pl:nom.gen.dat.acc.inst.loc.voc:n:ncol
KRO	KRO	subst:sg.pl:nom.gen.dat.acc.inst.loc.voc:f
KRNy	KRN	subst:pl:nom.acc.voc:m3
KRNu	KRN	subst:sg:gen:m3
KRNów	KRN	subst:pl:gen:m3
KRNowi	KRN	subst:sg:dat:m3
KRNom	KRN	subst:pl:dat:m3
KRN	KRN	subst:sg.pl:nom.gen.dat.acc.inst.loc.voc:f
KRN	KRN	subst:sg:nom.acc:m3
KRNie	KRN	subst:sg:voc:m3
KRNie	KRN	subst:sg:loc:m3
KRNem	KRN	subst:sg:inst:m3
KRNami	KRN	subst:pl:inst:m3
KRNach	KRN	subst:pl:loc:m3
KRLD	KRLD	subst:sg.pl:nom.gen.dat.acc.inst.loc.voc:n:ncol
KRLD	KRLD	subst:sg.pl:nom.gen.dat.acc.inst.loc.voc:f
KPZRze	KPZR	subst:sg:voc:m3
KPZRze	KPZR	subst:sg:loc:m3
KPZRy	KPZR	subst:pl:nom.acc.voc:m3
KPZRu	KPZR	subst:sg:gen:m3
KPZRów	KPZR	subst:pl:gen:m3
KPZRowi	KPZR	subst:sg:dat:m3
KPZRom	KPZR	subst:pl:dat:m3
KPZR	KPZR	subst:sg.pl:nom.gen.dat.acc.inst.loc.voc:f
KPZR	KPZR	subst:sg:nom.acc:m3
KPZRem	KPZR	subst:sg:inst:m3
KPZRami	KPZR	subst:pl:inst:m3
KPZRach	KPZR	subst:pl:loc:m3
KP	KP:s2	subst:sg.pl:nom.gen.dat.acc.inst.loc.voc:m3
KP	KP:s1	subst:sg.pl:nom.gen.dat.acc.inst.loc.voc:m3
KPP	KPP	subst:sg.pl:nom.gen.dat.acc.inst.loc.voc:n:ncol
KPP	KPP	subst:sg.pl:nom.gen.dat.acc.inst.loc.voc:f
KPNy	KPN	subst:pl:nom.acc.voc:m3
KPNu	KPN	subst:sg:gen:m3
KPNów	KPN	subst:pl:gen:m3
KPNowi	KPN	subst:sg:dat:m3
KPNom	KPN	subst:pl:dat:m3
KPN	KPN	subst:sg:nom.acc:m3
KPNie	KPN	subst:sg:voc:m3
KPNie	KPN	subst:sg:loc:m3
KPNem	KPN	subst:sg:inst:m3
KPNami	KPN	subst:pl:inst:m3
KPNach	KPN	subst:pl:loc:m3
KORze	KOR	subst:sg:voc:m3
KORze	KOR	subst:sg:loc:m3
KORy	KOR	subst:pl:nom.acc.voc:m3
KORu	KOR	subst:sg:gen:m3
KORów	KOR	subst:pl:gen:m3
KORowi	KOR	subst:sg:dat:m3
KORom	KOR	subst:pl:dat:m3
KOR	KOR	subst:sg:nom.acc:m3
KORem	KOR	subst:sg:inst:m3
KORami	KOR	subst:pl:inst:m3
KORach	KOR	subst:pl:loc:m3
KNA	KNA	subst:sg.pl:nom.gen.dat.acc.inst.loc.voc:f
KMy	KM:s2	subst:pl:nom.acc.voc:m3
KMu	KM:s2	subst:sg:gen:m3
KMów	KM:s2	subst:pl:gen:m3
KMowi	KM:s2	subst:sg:dat:m3
KMom	KM:s2	subst:pl:dat:m3
KM	KM:s2	subst:sg.pl:nom.gen.dat.acc.inst.loc.voc:f
KM	KM:s2	subst:sg:nom.acc:m3
KMie	KM:s2	subst:sg:voc:m3
KMie	KM:s2	subst:sg:loc:m3
KMem	KM:s2	subst:sg:inst:m3
KMami	KM:s2	subst:pl:inst:m3
KMach	KM:s2	subst:pl:loc:m3
KMy	KM:s1	subst:pl:nom.acc.voc:m3
KMu	KM:s1	subst:sg:gen:m3
KMów	KM:s1	subst:pl:gen:m3
KMowi	KM:s1	subst:sg:dat:m3
KMom	KM:s1	subst:pl:dat:m3
KM	KM:s1	subst:sg:nom.acc:m3
KMie	KM:s1	subst:sg:voc:m3
KMie	KM:s1	subst:sg:loc:m3
KMem	KM:s1	subst:sg:inst:m3
KMami	KM:s1	subst:pl:inst:m3
KMach	KM:s1	subst:pl:loc:m3
KLMy	KLM	subst:pl:nom.acc.voc:m3
KLMu	KLM	subst:sg:gen:m3
KLMów	KLM	subst:pl:gen:m3
KLMowi	KLM	subst:sg:dat:m3
KLMom	KLM	subst:pl:dat:m3
KLM	KLM	subst:sg:nom.acc:m3
KLMie	KLM	subst:sg:voc:m3
KLMie	KLM	subst:sg:loc:m3
KLMem	KLM	subst:sg:inst:m3
KLMami	KLM	subst:pl:inst:m3
KLMach	KLM	subst:pl:loc:m3
KLD	KLD	subst:sg.pl:nom.gen.dat.acc.inst.loc.voc:n:ncol
KLD	KLD	subst:sg.pl:nom.gen.dat.acc.inst.loc.voc:m3
KKO	KKO:s2	subst:sg.pl:nom.gen.dat.acc.inst.loc.voc:n:ncol
KKO	KKO:s2	subst:sg.pl:nom.gen.dat.acc.inst.loc.voc:f
KKO	KKO:s1	subst:sg.pl:nom.gen.dat.acc.inst.loc.voc:n:ncol
KKO	KKO:s1	subst:sg.pl:nom.gen.dat.acc.inst.loc.voc:m3
KGHM	KGHM	subst:sg.pl:nom.gen.dat.acc.inst.loc.voc:m3
KGB	KGB	subst:sg.pl:nom.gen.dat.acc.inst.loc.voc:n:ncol
KGB	KGB	subst:sg.pl:nom.gen.dat.acc.inst.loc.voc:m3
KG	KG	subst:sg.pl:nom.gen.dat.acc.inst.loc.voc:n:ncol
KG	KG	subst:sg.pl:nom.gen.dat.acc.inst.loc.voc:f
KERMy	KERM	subst:pl:nom.acc.voc:m3
KERMu	KERM	subst:sg:gen:m3
KERMów	KERM	subst:pl:gen:m3
KERMowi	KERM	subst:sg:dat:m3
KERMom	KERM	subst:pl:dat:m3
KERM	KERM	subst:sg.pl:nom.gen.dat.acc.inst.loc.voc:m3
KERM	KERM	subst:sg:nom.acc:m3
KERMie	KERM	subst:sg:voc:m3
KERMie	KERM	subst:sg:loc:m3
KERMem	KERM	subst:sg:inst:m3
KERMami	KERM	subst:pl:inst:m3
KERMach	KERM	subst:pl:loc:m3
KEPy	KEP	subst:pl:nom.acc.voc:m3
KEPu	KEP	subst:sg:gen:m3
KEPów	KEP	subst:pl:gen:m3
KEPowi	KEP	subst:sg:dat:m3
KEPom	KEP	subst:pl:dat:m3
KEP	KEP	subst:sg.pl:nom.gen.dat.acc.inst.loc.voc:f
KEP	KEP	subst:sg:nom.acc:m3
KEPie	KEP	subst:sg:voc:m3
KEPie	KEP	subst:sg:loc:m3
KEPem	KEP	subst:sg:inst:m3
KEPami	KEP	subst:pl:inst:m3
KEPach	KEP	subst:pl:loc:m3
KENy	KEN	subst:pl:nom.acc.voc:m3
KENu	KEN	subst:sg:gen:m3
KENów	KEN	subst:pl:gen:m3
KENowi	KEN	subst:sg:dat:m3
KENom	KEN	subst:pl:dat:m3
KEN	KEN	subst:sg.pl:nom.gen.dat.acc.inst.loc.voc:f
KEN	KEN	subst:sg:nom.acc:m3
KENie	KEN	subst:sg:voc:m3
KENie	KEN	subst:sg:loc:m3
KENem	KEN	subst:sg:inst:m3
KENami	KEN	subst:pl:inst:m3
KENach	KEN	subst:pl:loc:m3
KE	KE	subst:sg.pl:nom.gen.dat.acc.inst.loc.voc:f
KC	KC	subst:sg.pl:nom.gen.dat.acc.inst.loc.voc:n:ncol
KC	KC	subst:sg.pl:nom.gen.dat.acc.inst.loc.voc:m3
KBW	KBW:s3	subst:sg.pl:nom.gen.dat.acc.inst.loc.voc:n:ncol
KBW	KBW:s3	subst:sg.pl:nom.gen.dat.acc.inst.loc.voc:m3
KBW	KBW:s1	subst:sg.pl:nom.gen.dat.acc.inst.loc.voc:n:ncol
KBWE	KBWE	subst:sg.pl:nom.gen.dat.acc.inst.loc.voc:n:ncol
KBWE	KBWE	subst:sg.pl:nom.gen.dat.acc.inst.loc.voc:f
KBNy	KBN	subst:pl:nom.acc.voc:m3
KBNu	KBN	subst:sg:gen:m3
KBNów	KBN	subst:pl:gen:m3
KBNowi	KBN	subst:sg:dat:m3
KBNom	KBN	subst:pl:dat:m3
KBN	KBN	subst:sg:nom.acc:m3
KBNie	KBN	subst:sg:voc:m3
KBNie	KBN	subst:sg:loc:m3
KBNem	KBN	subst:sg:inst:m3
KBNami	KBN	subst:pl:inst:m3
KBNach	KBN	subst:pl:loc:m3
KALu	KAL	subst:sg:voc:m3
KALu	KAL	subst:sg:loc:m3
KALu	KAL	subst:sg:gen:m3
KALowi	KAL	subst:sg:dat:m3
KALom	KAL	subst:pl:dat:m3
KAL	KAL	subst:sg:nom.acc:m3
KALi	KAL	subst:pl:gen:m3
KALem	KAL	subst:sg:inst:m3
KALe	KAL	subst:pl:nom.acc.voc:m3
KALami	KAL	subst:pl:inst:m3
KALach	KAL	subst:pl:loc:m3
KAIu	KAI	subst:sg:voc:m3
KAIu	KAI	subst:sg:loc:m3
KAIu	KAI	subst:sg:gen:m3
KAIowi	KAI	subst:sg:dat:m3
KAIom	KAI	subst:pl:dat:m3
KAI	KAI	subst:sg.pl:nom.gen.dat.acc.inst.loc.voc:f
KAI	KAI	subst:sg:nom.acc:m3
KAIi	KAI	subst:pl:gen:m3
KAIem	KAI	subst:sg:inst:m3
KAIe	KAI	subst:pl:nom.acc.voc:m3
KAIami	KAI	subst:pl:inst:m3
KAIach	KAI	subst:pl:loc:m3
JANA	JANA	subst:sg.pl:nom.gen.dat.acc.inst.loc.voc:f
JAL	JAL	subst:sg.pl:nom.gen.dat.acc.inst.loc.voc:m3
ITI	ITI	subst:sg.pl:nom.gen.dat.acc.inst.loc.voc:n:ncol
ITI	ITI	subst:sg.pl:nom.gen.dat.acc.inst.loc.voc:m3
ITARTASSy	ITARTASS	subst:pl:nom.acc.voc:m3
ITARTASSu	ITARTASS	subst:sg:gen:m3
ITARTASSów	ITARTASS	subst:pl:gen:m3
ITARTASSowi	ITARTASS	subst:sg:dat:m3
ITARTASSom	ITARTASS	subst:pl:dat:m3
ITARTASS	ITARTASS	subst:sg.pl:nom.gen.dat.acc.inst.loc.voc:f
ITARTASS	ITARTASS	subst:sg:nom.acc:m3
ITARTASSie	ITARTASS	subst:sg:voc:m3
ITARTASSie	ITARTASS	subst:sg:loc:m3
ITARTASSem	ITARTASS	subst:sg:inst:m3
ITARTASSami	ITARTASS	subst:pl:inst:m3
ITARTASSach	ITARTASS	subst:pl:loc:m3
ISSNy	ISSN	subst:pl:nom.acc.voc:m3
ISSNu	ISSN	subst:sg:gen:m3
ISSNów	ISSN	subst:pl:gen:m3
ISSNowi	ISSN	subst:sg:dat:m3
ISSNom	ISSN	subst:pl:dat:m3
ISSN	ISSN	subst:sg.pl:nom.gen.dat.acc.inst.loc.voc:m3
ISSN	ISSN	subst:sg:nom.acc:m3
ISSNie	ISSN	subst:sg:voc:m3
ISSNie	ISSN	subst:sg:loc:m3
ISSNem	ISSN	subst:sg:inst:m3
ISSNami	ISSN	subst:pl:inst:m3
ISSNach	ISSN	subst:pl:loc:m3
ISO	ISO	subst:sg.pl:nom.gen.dat.acc.inst.loc.voc:n:ncol
ISO	ISO	subst:sg.pl:nom.gen.dat.acc.inst.loc.voc:f
ISDNy	ISDN	subst:pl:nom.acc.voc:m3
ISDNu	ISDN	subst:sg:gen:m3
ISDNów	ISDN	subst:pl:gen:m3
ISDNowi	ISDN	subst:sg:dat:m3
ISDNom	ISDN	subst:pl:dat:m3
ISDN	ISDN	subst:sg.pl:nom.gen.dat.acc.inst.loc.voc:m3
ISDN	ISDN	subst:sg:nom.acc:m3
ISDNie	ISDN	subst:sg:voc:m3
ISDNie	ISDN	subst:sg:loc:m3
ISDNem	ISDN	subst:sg:inst:m3
ISDNami	ISDN	subst:pl:inst:m3
ISDNach	ISDN	subst:pl:loc:m3
ISBNy	ISBN	subst:pl:nom.acc.voc:m3
ISBNu	ISBN	subst:sg:gen:m3
ISBNów	ISBN	subst:pl:gen:m3
ISBNowi	ISBN	subst:sg:dat:m3
ISBNom	ISBN	subst:pl:dat:m3
ISBN	ISBN	subst:sg.pl:nom.gen.dat.acc.inst.loc.voc:m3
ISBN	ISBN	subst:sg:nom.acc:m3
ISBNie	ISBN	subst:sg:voc:m3
ISBNie	ISBN	subst:sg:loc:m3
ISBNem	ISBN	subst:sg:inst:m3
ISBNami	ISBN	subst:pl:inst:m3
ISBNach	ISBN	subst:pl:loc:m3
IS	IS	subst:sg.pl:nom.gen.dat.acc.inst.loc.voc:n:ncol
IS	IS	subst:sg.pl:nom.gen.dat.acc.inst.loc.voc:m3
IRA	IRA	subst:sg.pl:nom.gen.dat.acc.inst.loc.voc:f
IQ	IQ	subst:sg.pl:nom.gen.dat.acc.inst.loc.voc:n:ncol
IQ	IQ	subst:sg.pl:nom.gen.dat.acc.inst.loc.voc:m3
IPNy	IPN	subst:pl:nom.acc.voc:m3
IPNu	IPN	subst:sg:gen:m3
IPNów	IPN	subst:pl:gen:m3
IPNowi	IPN	subst:sg:dat:m3
IPNom	IPN	subst:pl:dat:m3
IPN	IPN	subst:sg.pl:nom.gen.dat.acc.inst.loc.voc:m3
IPN	IPN	subst:sg:nom.acc:m3
IPNie	IPN	subst:sg:voc:m3
IPNie	IPN	subst:sg:loc:m3
IPNem	IPN	subst:sg:inst:m3
IPNami	IPN	subst:pl:inst:m3
IPNach	IPN	subst:pl:loc:m3
IP	IP	subst:sg.pl:nom.gen.dat.acc.inst.loc.voc:n:ncol
IP	IP	subst:sg.pl:nom.gen.dat.acc.inst.loc.voc:m3
INA	INA	subst:sg.pl:nom.gen.dat.acc.inst.loc.voc:f
IMiDzie	IMiD	subst:sg:voc:m3
IMiDzie	IMiD	subst:sg:loc:m3
IMiDy	IMiD	subst:pl:nom.acc.voc:m3
IMiDu	IMiD	subst:sg:gen:m3
IMiDów	IMiD	subst:pl:gen:m3
IMiDowi	IMiD	subst:sg:dat:m3
IMiDom	IMiD	subst:pl:dat:m3
IMiD	IMiD	subst:sg:nom.acc:m3
IMiDem	IMiD	subst:sg:inst:m3
IMiDami	IMiD	subst:pl:inst:m3
IMiDach	IMiD	subst:pl:loc:m3
IFORze	IFOR	subst:sg:voc:m3
IFORze	IFOR	subst:sg:loc:m3
IFORy	IFOR	subst:pl:nom.acc.voc:m3
IFORu	IFOR	subst:sg:gen:m3
IFORów	IFOR	subst:pl:gen:m3
IFORowi	IFOR	subst:sg:dat:m3
IFORom	IFOR	subst:pl:dat:m3
IFOR	IFOR	subst:sg:nom.acc:m3
IFORem	IFOR	subst:sg:inst:m3
IFORami	IFOR	subst:pl:inst:m3
IFORach	IFOR	subst:pl:loc:m3
IDE	IDE	subst:sg.pl:nom.gen.dat.acc.inst.loc.voc:n:ncol
IDE	IDE	subst:sg.pl:nom.gen.dat.acc.inst.loc.voc:m3
ICJoty	ICJ	subst:pl:nom.acc.voc:m3
ICJotu	ICJ	subst:sg:gen:m3
ICJotów	ICJ	subst:pl:gen:m3
ICJotowi	ICJ	subst:sg:dat:m3
ICJotom	ICJ	subst:pl:dat:m3
ICJotem	ICJ	subst:sg:inst:m3
ICJotami	ICJ	subst:pl:inst:m3
ICJotach	ICJ	subst:pl:loc:m3
ICJocie	ICJ	subst:sg:voc:m3
ICJocie	ICJ	subst:sg:loc:m3
ICJ	ICJ	subst:sg.pl:nom.gen.dat.acc.inst.loc.voc:m3
ICJ	ICJ	subst:sg:nom.acc:m3
IBMy	IBM	subst:pl:nom.acc.voc:m3
IBMu	IBM	subst:sg:gen:m3
IBMów	IBM	subst:pl:gen:m3
IBMowi	IBM	subst:sg:dat:m3
IBMom	IBM	subst:pl:dat:m3
IBMie	IBM	subst:sg:voc:m3
IBMie	IBM	subst:sg:loc:m3
IBM	IBM	subst:sg.pl:nom.gen.dat.acc.inst.loc.voc:n:ncol
IBM	IBM	subst:sg:nom.acc:m3
IBMem	IBM	subst:sg:inst:m3
IBMami	IBM	subst:pl:inst:m3
IBMach	IBM	subst:pl:loc:m3
IBLu	IBL	subst:sg:voc:m3
IBLu	IBL	subst:sg:loc:m3
IBLu	IBL	subst:sg:gen:m3
IBLowi	IBL	subst:sg:dat:m3
IBLom	IBL	subst:pl:dat:m3
IBLi	IBL	subst:pl:gen:m3
IBL	IBL	subst:sg:nom.acc:m3
IBLem	IBL	subst:sg:inst:m3
IBLe	IBL	subst:pl:nom.acc.voc:m3
IBLami	IBL	subst:pl:inst:m3
IBLach	IBL	subst:pl:loc:m3
HTTP	HTTP	subst:sg.pl:nom.gen.dat.acc.inst.loc.voc:m3
HTMLu	HTML	subst:sg:voc:m3
HTMLu	HTML	subst:sg:voc:m2
HTMLu	HTML	subst:sg:loc:m3
HTMLu	HTML	subst:sg:loc:m2
HTMLu	HTML	subst:sg:gen:m3
HTMLów	HTML	subst:pl:gen:m2
HTMLowi	HTML	subst:sg:dat:m3
HTMLowi	HTML	subst:sg:dat:m2
HTMLom	HTML	subst:pl:dat:m3
HTMLom	HTML	subst:pl:dat:m2
HTMLi	HTML	subst:pl:gen:m3
HTML	HTML	subst:sg:nom:m2
HTML	HTML	subst:sg:nom.acc:m3
HTMLem	HTML	subst:sg:inst:m3
HTMLem	HTML	subst:sg:inst:m2
HTMLe	HTML	subst:pl:nom.acc.voc:m3
HTMLe	HTML	subst:pl:nom.acc.voc:m2
HTMLami	HTML	subst:pl:inst:m3
HTMLami	HTML	subst:pl:inst:m2
HTMLa	HTML	subst:sg:gen:m2
HTMLa	HTML	subst:sg:gen.acc:m2
HTMLach	HTML	subst:pl:loc:m3
HTMLach	HTML	subst:pl:loc:m2
HSP	HSP	subst:sg.pl:nom.gen.dat.acc.inst.loc.voc:m3
HP	HP	subst:sg.pl:nom.gen.dat.acc.inst.loc.voc:n:ncol
HP	HP	subst:sg.pl:nom.gen.dat.acc.inst.loc.voc:m3
HIVy	HIV	subst:pl:nom.acc.voc:m3
HIVy	HIV	subst:pl:nom.acc.voc:m2
HIVu	HIV	subst:sg:gen:m3
HIVów	HIV	subst:pl:gen:m3
HIVów	HIV	subst:pl:gen:m2
HIVowi	HIV	subst:sg:dat:m3
HIVowi	HIV	subst:sg:dat:m2
HIVom	HIV	subst:pl:dat:m3
HIVom	HIV	subst:pl:dat:m2
HIVie	HIV	subst:sg:voc:m3
HIVie	HIV	subst:sg:voc:m2
HIVie	HIV	subst:sg:loc:m3
HIVie	HIV	subst:sg:loc:m2
HIV	HIV	subst:sg.pl:nom.gen.dat.acc.inst.loc.voc:n:ncol
HIV	HIV	subst:sg:nom:m2
HIV	HIV	subst:sg:nom.acc:m3
HIVem	HIV	subst:sg:inst:m3
HIVem	HIV	subst:sg:inst:m2
HIVami	HIV	subst:pl:inst:m3
HIVami	HIV	subst:pl:inst:m2
HIVa	HIV	subst:sg:gen:m2
HIVa	HIV	subst:sg:gen.acc:m2
HIVach	HIV	subst:pl:loc:m3
HIVach	HIV	subst:pl:loc:m2
HDZ	HDZ	subst:sg.pl:nom.gen.dat.acc.inst.loc.voc:f
HDZ	HDZ	subst:sg:nom.acc:m3
HDZety	HDZ	subst:pl:nom.acc.voc:m3
HDZetu	HDZ	subst:sg:gen:m3
HDZetów	HDZ	subst:pl:gen:m3
HDZetowi	HDZ	subst:sg:dat:m3
HDZetom	HDZ	subst:pl:dat:m3
HDZetem	HDZ	subst:sg:inst:m3
HDZetami	HDZ	subst:pl:inst:m3
HDZetach	HDZ	subst:pl:loc:m3
HDZecie	HDZ	subst:sg:voc:m3
HDZecie	HDZ	subst:sg:loc:m3
HDLu	HDL	subst:sg:voc:m3
HDLu	HDL	subst:sg:loc:m3
HDLu	HDL	subst:sg:gen:m3
HDLowi	HDL	subst:sg:dat:m3
HDLom	HDL	subst:pl:dat:m3
HDLi	HDL	subst:pl:gen:m3
HDL	HDL	subst:sg:nom.acc:m3
HDLem	HDL	subst:sg:inst:m3
HDLe	HDL	subst:pl:nom.acc.voc:m3
HDLami	HDL	subst:pl:inst:m3
HDLach	HDL	subst:pl:loc:m3
HDD	HDD	subst:sg.pl:nom.gen.dat.acc.inst.loc.voc:n:ncol
HDD	HDD	subst:sg.pl:nom.gen.dat.acc.inst.loc.voc:m3
HBO	HBO	subst:sg.pl:nom.gen.dat.acc.inst.loc.voc:n:ncol
HB	HB	subst:sg.pl:nom.gen.dat.acc.inst.loc.voc:m3
GUSy	GUS	subst:pl:nom.acc.voc:m3
GUSu	GUS	subst:sg:gen:m3
GUSów	GUS	subst:pl:gen:m3
GUSowi	GUS	subst:sg:dat:m3
GUSom	GUS	subst:pl:dat:m3
GUSie	GUS	subst:sg:voc:m3
GUSie	GUS	subst:sg:loc:m3
GUS	GUS	subst:sg:nom.acc:m3
GUSem	GUS	subst:sg:inst:m3
GUSami	GUS	subst:pl:inst:m3
GUSach	GUS	subst:pl:loc:m3
GUCu	GUC	subst:sg:voc:m3
GUCu	GUC	subst:sg:loc:m3
GUCu	GUC	subst:sg:gen:m3
GUCów	GUC	subst:pl:gen:m3
GUCowi	GUC	subst:sg:dat:m3
GUCom	GUC	subst:pl:dat:m3
GUC	GUC	subst:sg:nom.acc:m3
GUCem	GUC	subst:sg:inst:m3
GUCe	GUC	subst:pl:nom.acc.voc:m3
GUCami	GUC	subst:pl:inst:m3
GUCach	GUC	subst:pl:loc:m3
GSM	GSM	subst:sg.pl:nom.gen.dat.acc.inst.loc.voc:m3
GSy	GS	subst:pl:nom.acc.voc:m3
GSu	GS	subst:sg:gen:m3
GSów	GS	subst:pl:gen:m3
GSowi	GS	subst:sg:dat:m3
GSom	GS	subst:pl:dat:m3
GSie	GS	subst:sg:voc:m3
GSie	GS	subst:sg:loc:m3
GS	GS	subst:sg:nom.acc:m3
GSem	GS	subst:sg:inst:m3
GSami	GS	subst:pl:inst:m3
GSach	GS	subst:pl:loc:m3
GPU	GPU	subst:sg.pl:nom.gen.dat.acc.inst.loc.voc:n:ncol
GPSy	GPS	subst:pl:nom.acc.voc:m3
GPSu	GPS	subst:sg:gen:m3
GPSów	GPS	subst:pl:gen:m3
GPSowi	GPS	subst:sg:dat:m3
GPSom	GPS	subst:pl:dat:m3
GPSie	GPS	subst:sg:voc:m3
GPSie	GPS	subst:sg:loc:m3
GPS	GPS	subst:sg:nom.acc:m3
GPSem	GPS	subst:sg:inst:m3
GPSami	GPS	subst:pl:inst:m3
GPSach	GPS	subst:pl:loc:m3
GPRSy	GPRS	subst:pl:nom.acc.voc:m3
GPRSu	GPRS	subst:sg:gen:m3
GPRSów	GPRS	subst:pl:gen:m3
GPRSowi	GPRS	subst:sg:dat:m3
GPRSom	GPRS	subst:pl:dat:m3
GPRSie	GPRS	subst:sg:voc:m3
GPRSie	GPRS	subst:sg:loc:m3
GPRS	GPRS	subst:sg:nom.acc:m3
GPRSem	GPRS	subst:sg:inst:m3
GPRSami	GPRS	subst:pl:inst:m3
GPRSach	GPRS	subst:pl:loc:m3
GOPRze	GOPR	subst:sg:voc:m3
GOPRze	GOPR	subst:sg:loc:m3
GOPRy	GOPR	subst:pl:nom.acc.voc:m3
GOPRu	GOPR	subst:sg:gen:m3
GOPRów	GOPR	subst:pl:gen:m3
GOPRowi	GOPR	subst:sg:dat:m3
GOPRom	GOPR	subst:pl:dat:m3
GOPR	GOPR	subst:sg:nom.acc:m3
GOPRem	GOPR	subst:sg:inst:m3
GOPRami	GOPR	subst:pl:inst:m3
GOPRach	GOPR	subst:pl:loc:m3
GMC	GMC	subst:sg.pl:nom.gen.dat.acc.inst.loc.voc:n:ncol
GMy	GM	subst:pl:nom.acc.voc:m3
GMu	GM	subst:sg:gen:m3
GMów	GM	subst:pl:gen:m3
GMowi	GM	subst:sg:dat:m3
GMom	GM	subst:pl:dat:m3
GMie	GM	subst:sg:voc:m3
GMie	GM	subst:sg:loc:m3
GM	GM	subst:sg:nom.acc:m3
GMem	GM	subst:sg:inst:m3
GMami	GM	subst:pl:inst:m3
GMach	GM	subst:pl:loc:m3
GLu	GL	subst:sg:voc:m3
GLu	GL	subst:sg:loc:m3
GLu	GL	subst:sg:gen:m3
GLowi	GL	subst:sg:dat:m3
GLom	GL	subst:pl:dat:m3
GLi	GL	subst:pl:gen:m3
GL	GL	subst:sg.pl:nom.gen.dat.acc.inst.loc.voc:f
GL	GL	subst:sg:nom.acc:m3
GLem	GL	subst:sg:inst:m3
GLe	GL	subst:pl:nom.acc.voc:m3
GLami	GL	subst:pl:inst:m3
GLach	GL	subst:pl:loc:m3
GKSy	GKS	subst:pl:nom.acc.voc:m3
GKSu	GKS	subst:sg:gen:m3
GKSów	GKS	subst:pl:gen:m3
GKSowi	GKS	subst:sg:dat:m3
GKSom	GKS	subst:pl:dat:m3
GKSie	GKS	subst:sg:voc:m3
GKSie	GKS	subst:sg:loc:m3
GKS	GKS	subst:sg:nom.acc:m3
GKSem	GKS	subst:sg:inst:m3
GKSami	GKS	subst:pl:inst:m3
GKSach	GKS	subst:pl:loc:m3
GIODO	GIODO	subst:sg.pl:nom.gen.dat.acc.inst.loc.voc:m3
GBW	GBW	subst:sg.pl:nom.gen.dat.acc.inst.loc.voc:n:ncol
GBW	GBW	subst:sg.pl:nom.gen.dat.acc.inst.loc.voc:m3
GBH	GBH	subst:sg.pl:nom.gen.dat.acc.inst.loc.voc:m3
GBGK	GBGK	subst:sg.pl:nom.gen.dat.acc.inst.loc.voc:m3
GATTy	GATT	subst:pl:nom.acc.voc:m3
GATTu	GATT	subst:sg:gen:m3
GATTów	GATT	subst:pl:gen:m3
GATTowi	GATT	subst:sg:dat:m3
GATTom	GATT	subst:pl:dat:m3
GATT	GATT	subst:sg.pl:nom.gen.dat.acc.inst.loc.voc:n:ncol
GATT	GATT	subst:sg:nom.acc:m3
GATTem	GATT	subst:sg:inst:m3
GATTami	GATT	subst:pl:inst:m3
GATTach	GATT	subst:pl:loc:m3
GATcie	GATT	subst:sg:voc:m3
GATcie	GATT	subst:sg:loc:m3
FTP	FTP	subst:sg.pl:nom.gen.dat.acc.inst.loc.voc:n:ncol
FSO	FSO	subst:sg.pl:nom.gen.dat.acc.inst.loc.voc:n:ncol
FSO	FSO	subst:sg.pl:nom.gen.dat.acc.inst.loc.voc:f
FSMy	FSM	subst:pl:nom.acc.voc:m3
FSMu	FSM	subst:sg:gen:m3
FSMów	FSM	subst:pl:gen:m3
FSMowi	FSM	subst:sg:dat:m3
FSMom	FSM	subst:pl:dat:m3
FSMie	FSM	subst:sg:voc:m3
FSMie	FSM	subst:sg:loc:m3
FSM	FSM	subst:sg:nom.acc:m3
FSMem	FSM	subst:sg:inst:m3
FSMami	FSM	subst:pl:inst:m3
FSMach	FSM	subst:pl:loc:m3
FPŻy	FPŻ	subst:pl:nom.acc.voc:m3
FPŻu	FPŻ	subst:sg:gen:m3
FPŻów	FPŻ	subst:pl:gen:m3
FPŻowi	FPŻ	subst:sg:dat:m3
FPŻom	FPŻ	subst:pl:dat:m3
FPŻ	FPŻ	subst:sg:nom.acc:m3
FPŻety	FPŻ	subst:pl:nom.acc.voc:m3
FPŻetu	FPŻ	subst:sg:gen:m3
FPŻetów	FPŻ	subst:pl:gen:m3
FPŻetowi	FPŻ	subst:sg:dat:m3
FPŻetom	FPŻ	subst:pl:dat:m3
FPŻetem	FPŻ	subst:sg:inst:m3
FPŻetami	FPŻ	subst:pl:inst:m3
FPŻetach	FPŻ	subst:pl:loc:m3
FPŻem	FPŻ	subst:sg:inst:m3
FPŻecie	FPŻ	subst:sg:voc:m3
FPŻecie	FPŻ	subst:sg:loc:m3
FPŻami	FPŻ	subst:pl:inst:m3
FPŻach	FPŻ	subst:pl:loc:m3
FOZZy	FOZZ	subst:pl:nom.acc.voc:m3
FOZZu	FOZZ	subst:sg:gen:m3
FOZZów	FOZZ	subst:pl:gen:m3
FOZZowi	FOZZ	subst:sg:dat:m3
FOZZom	FOZZ	subst:pl:dat:m3
FOZZie	FOZZ	subst:sg:voc:m3
FOZZie	FOZZ	subst:sg:loc:m3
FOZZ	FOZZ	subst:sg:nom.acc:m3
FOZZem	FOZZ	subst:sg:inst:m3
FOZZami	FOZZ	subst:pl:inst:m3
FOZZach	FOZZ	subst:pl:loc:m3
FNy	FN	subst:pl:nom.acc.voc:m3
FNu	FN	subst:sg:gen:m3
FNów	FN	subst:pl:gen:m3
FNowi	FN	subst:sg:dat:m3
FNom	FN	subst:pl:dat:m3
FNie	FN	subst:sg:voc:m3
FNie	FN	subst:sg:loc:m3
FN	FN	subst:sg.pl:nom.gen.dat.acc.inst.loc.voc:n:ncol
FN	FN	subst:sg:nom.acc:m3
FNem	FN	subst:sg:inst:m3
FNami	FN	subst:pl:inst:m3
FNach	FN	subst:pl:loc:m3
FK	FK	subst:sg.pl:nom.gen.dat.acc.inst.loc.voc:f
FIFy	FIFA	subst:sg:gen:f
FIFy	FIFA	subst:pl:nom.acc.voc:f
FIFom	FIFA	subst:pl:dat:f
FIFo	FIFA	subst:sg:voc:f
FIFie	FIFA	subst:sg:dat.loc:f
FIF	FIFA	subst:pl:gen:f
FIFę	FIFA	subst:sg:acc:f
FIFą	FIFA	subst:sg:inst:f
FIFami	FIFA	subst:pl:inst:f
FIFA	FIFA	subst:sg.pl:nom.gen.dat.acc.inst.loc.voc:n:ncol
FIFA	FIFA	subst:sg:nom:f
FIFach	FIFA	subst:pl:loc:f
FIDE	FIDE	subst:sg.pl:nom.gen.dat.acc.inst.loc.voc:f
FDP	FDP:s2	subst:sg.pl:nom.gen.dat.acc.inst.loc.voc:n:ncol
FDP	FDP:s1	subst:sg.pl:nom.gen.dat.acc.inst.loc.voc:n:ncol
FDP	FDP:s1	subst:sg.pl:nom.gen.dat.acc.inst.loc.voc:f
FDD	FDD	subst:sg.pl:nom.gen.dat.acc.inst.loc.voc:n:ncol
FDD	FDD	subst:sg.pl:nom.gen.dat.acc.inst.loc.voc:m3
FC	FC	subst:sg.pl:nom.gen.dat.acc.inst.loc.voc:n:ncol
FC	FC	subst:sg.pl:nom.gen.dat.acc.inst.loc.voc:m3
FBI	FBI	subst:sg.pl:nom.gen.dat.acc.inst.loc.voc:n:ncol
FATAHy	FATAH	subst:pl:nom.acc.voc:m3
FATAHu	FATAH	subst:sg:voc:m3
FATAHu	FATAH	subst:sg:loc:m3
FATAHu	FATAH	subst:sg:gen:m3
FATAHów	FATAH	subst:pl:gen:m3
FATAHowi	FATAH	subst:sg:dat:m3
FATAHom	FATAH	subst:pl:dat:m3
FATAH	FATAH	subst:sg:nom.acc:m3
FATAHem	FATAH	subst:sg:inst:m3
FATAHami	FATAH	subst:pl:inst:m3
FATAHach	FATAH	subst:pl:loc:m3
FATy	FAT	subst:pl:nom.acc.voc:m3
FATu	FAT	subst:sg:gen:m3
FATów	FAT	subst:pl:gen:m3
FATowi	FAT	subst:sg:dat:m3
FATom	FAT	subst:pl:dat:m3
FAT	FAT	subst:sg.pl:nom.gen.dat.acc.inst.loc.voc:m3
FAT	FAT	subst:sg:nom.acc:m3
FATem	FAT	subst:sg:inst:m3
FATami	FAT	subst:pl:inst:m3
FATach	FAT	subst:pl:loc:m3
FAcie	FAT	subst:sg:voc:m3
Facie	FAT	subst:sg:voc:m3
FAcie	FAT	subst:sg:loc:m3
Facie	FAT	subst:sg:loc:m3
FASy	FAS	subst:pl:nom.acc.voc:m3
FASu	FAS	subst:sg:gen:m3
FASów	FAS	subst:pl:gen:m3
FASowi	FAS	subst:sg:dat:m3
FASom	FAS	subst:pl:dat:m3
FASie	FAS	subst:sg:voc:m3
FASie	FAS	subst:sg:loc:m3
FAS	FAS	subst:sg:nom.acc:m3
FASem	FAS	subst:sg:inst:m3
FASami	FAS	subst:pl:inst:m3
FASach	FAS	subst:pl:loc:m3
FAO	FAO	subst:sg.pl:nom.gen.dat.acc.inst.loc.voc:n:ncol
FAO	FAO	subst:sg.pl:nom.gen.dat.acc.inst.loc.voc:f
FAMy	FAMA	subst:sg:gen:f
FAMy	FAMA	subst:pl:nom.acc.voc:f
FAMom	FAMA	subst:pl:dat:f
FAMo	FAMA	subst:sg:voc:f
FAMie	FAMA	subst:sg:dat.loc:f
FAM	FAMA	subst:pl:gen:f
FAMę	FAMA	subst:sg:acc:f
FAMą	FAMA	subst:sg:inst:f
FAMami	FAMA	subst:pl:inst:f
FAMA	FAMA	subst:sg:nom:f
FAMach	FAMA	subst:pl:loc:f
FADOMy	FADOM	subst:pl:nom.acc.voc:m3
FADOMu	FADOM	subst:sg:gen:m3
FADOMów	FADOM	subst:pl:gen:m3
FADOMowi	FADOM	subst:sg:dat:m3
FADOMom	FADOM	subst:pl:dat:m3
FADOMie	FADOM	subst:sg:voc:m3
FADOMie	FADOM	subst:sg:loc:m3
FADOM	FADOM	subst:sg:nom.acc:m3
FADOMem	FADOM	subst:sg:inst:m3
FADOMami	FADOM	subst:pl:inst:m3
FADOMach	FADOM	subst:pl:loc:m3
EWG	EWG	subst:sg.pl:nom.gen.dat.acc.inst.loc.voc:n:ncol
EWG	EWG	subst:sg.pl:nom.gen.dat.acc.inst.loc.voc:f
EUROPOLu	EUROPOL	subst:sg:voc:m3
EUROPOLu	EUROPOL	subst:sg:loc:m3
EUROPOLu	EUROPOL	subst:sg:gen:m3
EUROPOLowi	EUROPOL	subst:sg:dat:m3
EUROPOLom	EUROPOL	subst:pl:dat:m3
EUROPOLi	EUROPOL	subst:pl:gen:m3
EUROPOL	EUROPOL	subst:sg.pl:nom.gen.dat.acc.inst.loc.voc:n:ncol
EUROPOL	EUROPOL	subst:sg:nom.acc:m3
EUROPOLem	EUROPOL	subst:sg:inst:m3
EUROPOLe	EUROPOL	subst:pl:nom.acc.voc:m3
EUROPOLami	EUROPOL	subst:pl:inst:m3
EUROPOLach	EUROPOL	subst:pl:loc:m3
ETy	ETA	subst:sg:gen:f
ETy	ETA	subst:pl:nom.acc.voc:f
ETom	ETA	subst:pl:dat:f
ETo	ETA	subst:sg:voc:f
ETę	ETA	subst:sg:acc:f
ET	ETA	subst:pl:gen:f
ETą	ETA	subst:sg:inst:f
ETami	ETA	subst:pl:inst:f
ETA	ETA	subst:sg.pl:nom.gen.dat.acc.inst.loc.voc:f
ETA	ETA	subst:sg:nom:f
ETach	ETA	subst:pl:loc:f
Ecie	ETA	subst:sg:dat.loc:f
ESOPy	ESOP	subst:pl:nom.acc.voc:m3
ESOPu	ESOP	subst:sg:gen:m3
ESOPów	ESOP	subst:pl:gen:m3
ESOPowi	ESOP	subst:sg:dat:m3
ESOPom	ESOP	subst:pl:dat:m3
ESOPie	ESOP	subst:sg:voc:m3
ESOPie	ESOP	subst:sg:loc:m3
ESOP	ESOP	subst:sg:nom.acc:m3
ESOPem	ESOP	subst:sg:inst:m3
ESOPami	ESOP	subst:pl:inst:m3
ESOPach	ESOP	subst:pl:loc:m3
ERMy	ERM	subst:pl:nom.acc.voc:m3
ERMu	ERM	subst:sg:gen:m3
ERMów	ERM	subst:pl:gen:m3
ERMowi	ERM	subst:sg:dat:m3
ERMom	ERM	subst:pl:dat:m3
ERMie	ERM	subst:sg:voc:m3
ERMie	ERM	subst:sg:loc:m3
ERM	ERM	subst:sg:nom.acc:m3
ERMem	ERM	subst:sg:inst:m3
ERMami	ERM	subst:pl:inst:m3
ERMach	ERM	subst:pl:loc:m3
EPROMy	EPROM	subst:pl:nom.acc.voc:m3
EPROMu	EPROM	subst:sg:gen:m3
EPROMów	EPROM	subst:pl:gen:m3
EPROMowi	EPROM	subst:sg:dat:m3
EPROMom	EPROM	subst:pl:dat:m3
EPROMie	EPROM	subst:sg:voc:m3
EPROMie	EPROM	subst:sg:loc:m3
EPROM	EPROM	subst:sg:nom.acc:m3
EPROMem	EPROM	subst:sg:inst:m3
EPROMami	EPROM	subst:pl:inst:m3
EPROMach	EPROM	subst:pl:loc:m3
EPA	EPA	subst:sg.pl:nom.gen.dat.acc.inst.loc.voc:n:ncol
EPA	EPA	subst:sg.pl:nom.gen.dat.acc.inst.loc.voc:f
EP	EP	subst:sg.pl:nom.gen.dat.acc.inst.loc.voc:n:ncol
EP	EP	subst:sg.pl:nom.gen.dat.acc.inst.loc.voc:m3
ENEA	ENEA	subst:sg.pl:nom.gen.dat.acc.inst.loc.voc:f
EMG	EMG	subst:sg.pl:nom.gen.dat.acc.inst.loc.voc:n:ncol
ELTy	ELTA	subst:sg:gen:f
ELTy	ELTA	subst:pl:nom.acc.voc:f
ELTom	ELTA	subst:pl:dat:f
ELTo	ELTA	subst:sg:voc:f
ELTę	ELTA	subst:sg:acc:f
ELT	ELTA	subst:pl:gen:f
ELTą	ELTA	subst:sg:inst:f
ELTami	ELTA	subst:pl:inst:f
ELTA	ELTA	subst:sg.pl:nom.gen.dat.acc.inst.loc.voc:f
ELTA	ELTA	subst:sg:nom:f
ELTach	ELTA	subst:pl:loc:f
ELcie	ELTA	subst:sg:dat.loc:f
EKG	EKG	subst:sg.pl:nom.gen.dat.acc.inst.loc.voc:n:ncol
EFTy	EFTA	subst:sg:gen:f
EFTy	EFTA	subst:pl:nom.acc.voc:f
EFTom	EFTA	subst:pl:dat:f
EFTo	EFTA	subst:sg:voc:f
EFTę	EFTA	subst:sg:acc:f
EFT	EFTA	subst:pl:gen:f
EFTą	EFTA	subst:sg:inst:f
EFTami	EFTA	subst:pl:inst:f
EFTA	EFTA	subst:sg.pl:nom.gen.dat.acc.inst.loc.voc:f
EFTA	EFTA	subst:sg:nom:f
EFTach	EFTA	subst:pl:loc:f
EFcie	EFTA	subst:sg:dat.loc:f
EEG	EEG	subst:sg.pl:nom.gen.dat.acc.inst.loc.voc:n:ncol
ECU	ECU	subst:sg.pl:nom.gen.dat.acc.inst.loc.voc:n:ncol
EBU	EBU	subst:sg.pl:nom.gen.dat.acc.inst.loc.voc:n:ncol
EBORze	EBOR	subst:sg:voc:m3
EBORze	EBOR	subst:sg:loc:m3
EBORy	EBOR	subst:pl:nom.acc.voc:m3
EBORu	EBOR	subst:sg:gen:m3
EBORów	EBOR	subst:pl:gen:m3
EBORowi	EBOR	subst:sg:dat:m3
EBORom	EBOR	subst:pl:dat:m3
EBORem	EBOR	subst:sg:inst:m3
EBOR	EBOR	subst:sg:nom.acc:m3
EBORami	EBOR	subst:pl:inst:m3
EBORach	EBOR	subst:pl:loc:m3
EBOiRze	EBOiR	subst:sg:voc:m3
EBOiRze	EBOiR	subst:sg:loc:m3
EBOiRy	EBOiR	subst:pl:nom.acc.voc:m3
EBOiRu	EBOiR	subst:sg:gen:m3
EBOiRów	EBOiR	subst:pl:gen:m3
EBOiRowi	EBOiR	subst:sg:dat:m3
EBOiRom	EBOiR	subst:pl:dat:m3
EBOiRem	EBOiR	subst:sg:inst:m3
EBOiR	EBOiR	subst:sg:nom.acc:m3
EBOiRami	EBOiR	subst:pl:inst:m3
EBOiRach	EBOiR	subst:pl:loc:m3
EBI	EBI	subst:sg.pl:nom.gen.dat.acc.inst.loc.voc:m3
DVDROMy	DVDROM	subst:pl:nom.acc.voc:m3
DVDROMu	DVDROM	subst:sg:gen:m3
DVDROMów	DVDROM	subst:pl:gen:m3
DVDROMowi	DVDROM	subst:sg:dat:m3
DVDROMom	DVDROM	subst:pl:dat:m3
DVDROMie	DVDROM	subst:sg:voc:m3
DVDROMie	DVDROM	subst:sg:loc:m3
DVDROMem	DVDROM	subst:sg:inst:m3
DVDROM	DVDROM	subst:sg:nom.acc:m3
DVDROMami	DVDROM	subst:pl:inst:m3
DVDROMach	DVDROM	subst:pl:loc:m3
DVD	DVD	subst:sg.pl:nom.gen.dat.acc.inst.loc.voc:n:ncol
DTV	DTV	subst:sg.pl:nom.gen.dat.acc.inst.loc.voc:m3
DTP	DTP	subst:sg.pl:nom.gen.dat.acc.inst.loc.voc:n:ncol
DSy	DS	subst:pl:nom.acc.voc:m3
DSu	DS	subst:sg:gen:m3
DSów	DS	subst:pl:gen:m3
DSowi	DS	subst:sg:dat:m3
DSom	DS	subst:pl:dat:m3
DSie	DS	subst:sg:voc:m3
DSie	DS	subst:sg:loc:m3
DSem	DS	subst:sg:inst:m3
DS	DS	subst:sg:nom.acc:m3
DSami	DS	subst:pl:inst:m3
DSach	DS	subst:pl:loc:m3
DPA	DPA	subst:sg.pl:nom.gen.dat.acc.inst.loc.voc:n:ncol
DPA	DPA	subst:sg.pl:nom.gen.dat.acc.inst.loc.voc:f
DOSy	DOS	subst:pl:nom.acc.voc:m3
DOSy	DOS	subst:pl:nom.acc.voc:m2
DOSu	DOS	subst:sg:gen:m3
DOSów	DOS	subst:pl:gen:m3
DOSów	DOS	subst:pl:gen:m2
DOSowi	DOS	subst:sg:dat:m3
DOSowi	DOS	subst:sg:dat:m2
DOSom	DOS	subst:pl:dat:m3
DOSom	DOS	subst:pl:dat:m2
DOSie	DOS	subst:sg:voc:m3
DOSie	DOS	subst:sg:voc:m2
DOSie	DOS	subst:sg:loc:m3
DOSie	DOS	subst:sg:loc:m2
DOSem	DOS	subst:sg:inst:m3
DOSem	DOS	subst:sg:inst:m2
DOS	DOS	subst:sg:nom:m2
DOS	DOS	subst:sg:nom.acc:m3
DOSami	DOS	subst:pl:inst:m3
DOSami	DOS	subst:pl:inst:m2
DOSa	DOS	subst:sg:gen:m2
DOSa	DOS	subst:sg:gen.acc:m2
DOSach	DOS	subst:pl:loc:m3
DOSach	DOS	subst:pl:loc:m2
DOKP	DOKP	subst:sg.pl:nom.gen.dat.acc.inst.loc.voc:n:ncol
DOKP	DOKP	subst:sg.pl:nom.gen.dat.acc.inst.loc.voc:f
DNA	DNA	subst:sg.pl:nom.gen.dat.acc.inst.loc.voc:n:ncol
DNA	DNA	subst:sg.pl:nom.gen.dat.acc.inst.loc.voc:m3
DMy	DM	subst:pl:nom.acc.voc:m3
DMu	DM	subst:sg:gen:m3
DMów	DM	subst:pl:gen:m3
DMowi	DM	subst:sg:dat:m3
DMom	DM	subst:pl:dat:m3
DMie	DM	subst:sg:voc:m3
DMie	DM	subst:sg:loc:m3
DMem	DM	subst:sg:inst:m3
DM	DM	subst:sg:nom.acc:m3
DMami	DM	subst:pl:inst:m3
DMach	DM	subst:pl:loc:m3
DLSy	DLS	subst:pl:nom.acc.voc:m3
DLSu	DLS	subst:sg:gen:m3
DLSów	DLS	subst:pl:gen:m3
DLSowi	DLS	subst:sg:dat:m3
DLSom	DLS	subst:pl:dat:m3
DLSie	DLS	subst:sg:voc:m3
DLSie	DLS	subst:sg:loc:m3
DLSem	DLS	subst:sg:inst:m3
DLS	DLS	subst:sg:nom.acc:m3
DLSami	DLS	subst:pl:inst:m3
DLSach	DLS	subst:pl:loc:m3
DJu	DJ	subst:sg:voc:m1
DJu	DJ	subst:sg:loc:m1
DJów	DJ	subst:pl:gen.acc:m1
DJowi	DJ	subst:sg:dat:m1
DJom	DJ	subst:pl:dat:m1
DJi	DJ	subst:pl:gen.acc:m1
DJem	DJ	subst:sg:inst:m1
DJe	DJ	subst:pl:nom.voc:m1
DJe	DJ	depr:pl:nom.acc.voc:m2
DJ	DJ	subst:sg:nom:m1
DJami	DJ	subst:pl:inst:m1
DJa	DJ	subst:sg:gen:m1
DJa	DJ	subst:sg:gen.acc:m1
DJach	DJ	subst:pl:loc:m1
DHLu	DHL	subst:sg:voc:m3
DHLu	DHL	subst:sg:loc:m3
DHLu	DHL	subst:sg:gen:m3
DHLowi	DHL	subst:sg:dat:m3
DHLom	DHL	subst:pl:dat:m3
DHLi	DHL	subst:pl:gen:m3
DHLem	DHL	subst:sg:inst:m3
DHLe	DHL	subst:pl:nom.acc.voc:m3
DHL	DHL	subst:sg:nom.acc:m3
DHLami	DHL	subst:pl:inst:m3
DHLach	DHL	subst:pl:loc:m3
DDT	DDT	subst:sg.pl:nom.gen.dat.acc.inst.loc.voc:n:ncol
DDT	DDT	subst:sg.pl:nom.gen.dat.acc.inst.loc.voc:m3
DBP	DBP	subst:sg.pl:nom.gen.dat.acc.inst.loc.voc:n:ncol
DBP	DBP	subst:sg.pl:nom.gen.dat.acc.inst.loc.voc:m3
DBG	DBG	subst:sg.pl:nom.gen.dat.acc.inst.loc.voc:n:ncol
DBG	DBG	subst:sg.pl:nom.gen.dat.acc.inst.loc.voc:m3
dBASE	dBASE	subst:sg.pl:nom.gen.dat.acc.inst.loc.voc:n:ncol
DATy	DAT	subst:pl:nom.acc.voc:m3
DATu	DAT	subst:sg:gen:m3
DATów	DAT	subst:pl:gen:m3
DATowi	DAT	subst:sg:dat:m3
DATom	DAT	subst:pl:dat:m3
DATem	DAT	subst:sg:inst:m3
DAT	DAT	subst:sg.pl:nom.gen.dat.acc.inst.loc.voc:m3
DAT	DAT	subst:sg:nom.acc:m3
DATami	DAT	subst:pl:inst:m3
DATach	DAT	subst:pl:loc:m3
DAcie	DAT	subst:sg:voc:m3
Dacie	DAT	subst:sg:voc:m3
DAcie	DAT	subst:sg:loc:m3
Dacie	DAT	subst:sg:loc:m3
DABy	DAB	subst:pl:nom.acc.voc:m3
DABu	DAB	subst:sg:gen:m3
DABów	DAB	subst:pl:gen:m3
DABowi	DAB	subst:sg:dat:m3
DABom	DAB	subst:pl:dat:m3
DABie	DAB	subst:sg:voc:m3
DABie	DAB	subst:sg:loc:m3
DABem	DAB	subst:sg:inst:m3
DAB	DAB	subst:sg:nom.acc:m3
DABami	DAB	subst:pl:inst:m3
DABach	DAB	subst:pl:loc:m3
CZMP	CZMP	subst:sg.pl:nom.gen.dat.acc.inst.loc.voc:n:ncol
CZD	CZD	subst:sg.pl:nom.gen.dat.acc.inst.loc.voc:n:ncol
CWKSy	CWKS	subst:pl:nom.acc.voc:m3
CWKSu	CWKS	subst:sg:gen:m3
CWKSów	CWKS	subst:pl:gen:m3
CWKSowi	CWKS	subst:sg:dat:m3
CWKSom	CWKS	subst:pl:dat:m3
CWKSie	CWKS	subst:sg:voc:m3
CWKSie	CWKS	subst:sg:loc:m3
CWKSem	CWKS	subst:sg:inst:m3
CWKS	CWKS	subst:sg:nom.acc:m3
CWKSami	CWKS	subst:pl:inst:m3
CWKSach	CWKS	subst:pl:loc:m3
CV	CV	subst:sg.pl:nom.gen.dat.acc.inst.loc.voc:n:ncol
CTV	CTV	subst:sg.pl:nom.gen.dat.acc.inst.loc.voc:f
CSU	CSU	subst:sg.pl:nom.gen.dat.acc.inst.loc.voc:n:ncol
CSU	CSU	subst:sg.pl:nom.gen.dat.acc.inst.loc.voc:f
CRZZy	CRZZ	subst:pl:nom.acc.voc:m3
CRZZu	CRZZ	subst:sg:gen:m3
CRZZów	CRZZ	subst:pl:gen:m3
CRZZowi	CRZZ	subst:sg:dat:m3
CRZZom	CRZZ	subst:pl:dat:m3
CRZZety	CRZZ	subst:pl:nom.acc.voc:m3
CRZZetu	CRZZ	subst:sg:gen:m3
CRZZetów	CRZZ	subst:pl:gen:m3
CRZZetowi	CRZZ	subst:sg:dat:m3
CRZZetom	CRZZ	subst:pl:dat:m3
CRZZetem	CRZZ	subst:sg:inst:m3
CRZZetami	CRZZ	subst:pl:inst:m3
CRZZetach	CRZZ	subst:pl:loc:m3
CRZZem	CRZZ	subst:sg:inst:m3
CRZZecie	CRZZ	subst:sg:voc:m3
CRZZecie	CRZZ	subst:sg:loc:m3
CRZZ	CRZZ	subst:sg.pl:nom.gen.dat.acc.inst.loc.voc:m3
CRZZ	CRZZ	subst:sg:nom.acc:m3
CRZZami	CRZZ	subst:pl:inst:m3
CRZZach	CRZZ	subst:pl:loc:m3
CPU	CPU	subst:sg.pl:nom.gen.dat.acc.inst.loc.voc:n:ncol
CPNy	CPN	subst:pl:nom.acc.voc:m3
CPNu	CPN	subst:sg:gen:m3
CPNów	CPN	subst:pl:gen:m3
CPNowi	CPN	subst:sg:dat:m3
CPNom	CPN	subst:pl:dat:m3
CPNie	CPN	subst:sg:voc:m3
CPNie	CPN	subst:sg:loc:m3
CPNem	CPN	subst:sg:inst:m3
CPN	CPN	subst:sg.pl:nom.gen.dat.acc.inst.loc.voc:f
CPN	CPN	subst:sg:nom.acc:m3
CPNami	CPN	subst:pl:inst:m3
CPNach	CPN	subst:pl:loc:m3
CPLiA	CPLiA	subst:sg.pl:nom.gen.dat.acc.inst.loc.voc:f
COCOMy	COCOM	subst:pl:nom.acc.voc:m3
COCOMu	COCOM	subst:sg:gen:m3
COCOMów	COCOM	subst:pl:gen:m3
COCOMowi	COCOM	subst:sg:dat:m3
COCOMom	COCOM	subst:pl:dat:m3
COCOMie	COCOM	subst:sg:voc:m3
COCOMie	COCOM	subst:sg:loc:m3
COCOMem	COCOM	subst:sg:inst:m3
COCOM	COCOM	subst:sg:nom.acc:m3
COCOMami	COCOM	subst:pl:inst:m3
COCOMach	COCOM	subst:pl:loc:m3
CO	CO	subst:sg.pl:nom.gen.dat.acc.inst.loc.voc:n:ncol
CNNy	CNN	subst:pl:nom.acc.voc:m3
CNNu	CNN	subst:sg:gen:m3
CNNów	CNN	subst:pl:gen:m3
CNNowi	CNN	subst:sg:dat:m3
CNNom	CNN	subst:pl:dat:m3
CNNie	CNN	subst:sg:voc:m3
CNNie	CNN	subst:sg:loc:m3
CNNem	CNN	subst:sg:inst:m3
CNN	CNN	subst:sg.pl:nom.gen.dat.acc.inst.loc.voc:f
CNN	CNN	subst:sg:nom.acc:m3
CNNami	CNN	subst:pl:inst:m3
CNNach	CNN	subst:pl:loc:m3
CMYKu	CMYK	subst:sg:voc:m2
CMYKu	CMYK	subst:sg:loc:m2
CMYKów	CMYK	subst:pl:gen:m2
CMYKowi	CMYK	subst:sg:dat:m2
CMYKom	CMYK	subst:pl:dat:m2
CMYKiem	CMYK	subst:sg:inst:m2
CMYKi	CMYK	subst:pl:nom.acc.voc:m2
CMYK	CMYK	subst:sg:nom:m2
CMYKami	CMYK	subst:pl:inst:m2
CMYKa	CMYK	subst:sg:gen:m2
CMYKa	CMYK	subst:sg:gen.acc:m2
CMYKach	CMYK	subst:pl:loc:m2
CKŻP	CKŻP	subst:sg.pl:nom.gen.dat.acc.inst.loc.voc:n:ncol
CKŻP	CKŻP	subst:sg.pl:nom.gen.dat.acc.inst.loc.voc:m3
CKU	CKU	subst:sg.pl:nom.gen.dat.acc.inst.loc.voc:n:ncol
ckmy	ckm	subst:pl:nom.acc.voc:m3
ckmu	ckm	subst:sg:gen:m3
ckmów	ckm	subst:pl:gen:m3
ckmowi	ckm	subst:sg:dat:m3
ckmom	ckm	subst:pl:dat:m3
ckmie	ckm	subst:sg:voc:m3
ckmie	ckm	subst:sg:loc:m3
ckmem	ckm	subst:sg:inst:m3
ckm	ckm	subst:sg:nom.acc:m3
ckmami	ckm	subst:pl:inst:m3
ckmach	ckm	subst:pl:loc:m3
CK	CK	subst:sg.pl:nom.gen.dat.acc.inst.loc.voc:m3
CITy	CIT	subst:pl:nom.acc.voc:m3
CITu	CIT	subst:sg:gen:m3
CITów	CIT	subst:pl:gen:m3
CITowi	CIT	subst:sg:dat:m3
CITom	CIT	subst:pl:dat:m3
CITem	CIT	subst:sg:inst:m3
CIT	CIT	subst:sg.pl:nom.gen.dat.acc.inst.loc.voc:m3
CIT	CIT	subst:sg:nom.acc:m3
CITami	CIT	subst:pl:inst:m3
CITach	CIT	subst:pl:loc:m3
CIcie	CIT	subst:sg:voc:m3
Cicie	CIT	subst:sg:voc:m3
CIcie	CIT	subst:sg:loc:m3
Cicie	CIT	subst:sg:loc:m3
CINTE	CINTE	subst:sg.pl:nom.gen.dat.acc.inst.loc.voc:n:ncol
CIA	CIA	subst:sg.pl:nom.gen.dat.acc.inst.loc.voc:n:ncol
CIA	CIA	subst:sg.pl:nom.gen.dat.acc.inst.loc.voc:f
ChRLu	ChRL	subst:sg:voc:m3
ChRLu	ChRL	subst:sg:loc:m3
ChRLu	ChRL	subst:sg:gen:m3
ChRLowi	ChRL	subst:sg:dat:m3
ChRLom	ChRL	subst:pl:dat:m3
ChRLi	ChRL	subst:pl:gen:m3
ChRLem	ChRL	subst:sg:inst:m3
ChRLe	ChRL	subst:pl:nom.acc.voc:m3
ChRL	ChRL	subst:sg.pl:nom.gen.dat.acc.inst.loc.voc:m3
ChRL	ChRL	subst:sg.pl:nom.gen.dat.acc.inst.loc.voc:f
ChRL	ChRL	subst:sg:nom.acc:m3
ChRLami	ChRL	subst:pl:inst:m3
ChRLach	ChRL	subst:pl:loc:m3
ChD	ChD	subst:sg.pl:nom.gen.dat.acc.inst.loc.voc:n:ncol
ChD	ChD	subst:sg.pl:nom.gen.dat.acc.inst.loc.voc:f
CGS	CGS	subst:sg.pl:nom.gen.dat.acc.inst.loc.voc:n:ncol
CFC	CFC	subst:sg.pl:nom.gen.dat.acc.inst.loc.voc:n:ncol
CFC	CFC	subst:sg.pl:nom.gen.dat.acc.inst.loc.voc:m3
CEFTy	CEFTA	subst:sg:gen:f
CEFTy	CEFTA	subst:pl:nom.acc.voc:f
CEFTom	CEFTA	subst:pl:dat:f
CEFTo	CEFTA	subst:sg:voc:f
CEFTę	CEFTA	subst:sg:acc:f
CEFT	CEFTA	subst:pl:gen:f
CEFTą	CEFTA	subst:sg:inst:f
CEFTami	CEFTA	subst:pl:inst:f
CEFTach	CEFTA	subst:pl:loc:f
CEFTA	CEFTA	subst:sg.pl:nom.gen.dat.acc.inst.loc.voc:f
CEFTA	CEFTA	subst:sg:nom:f
CEFcie	CEFTA	subst:sg:dat.loc:f
CDU	CDU	subst:sg.pl:nom.gen.dat.acc.inst.loc.voc:n:ncol
CDU	CDU	subst:sg.pl:nom.gen.dat.acc.inst.loc.voc:f
CDROMy	CDROM	subst:pl:nom.acc.voc:m3
CDROMu	CDROM	subst:sg:gen:m3
CDROMów	CDROM	subst:pl:gen:m3
CDROMowi	CDROM	subst:sg:dat:m3
CDROMom	CDROM	subst:pl:dat:m3
CDROMie	CDROM	subst:sg:voc:m3
CDROMie	CDROM	subst:sg:loc:m3
CDROMem	CDROM	subst:sg:inst:m3
CDROM	CDROM	subst:sg:nom.acc:m3
CDROMami	CDROM	subst:pl:inst:m3
CDROMach	CDROM	subst:pl:loc:m3
CD	CD	subst:sg.pl:nom.gen.dat.acc.inst.loc.voc:n:ncol
CD	CD	subst:sg.pl:nom.gen.dat.acc.inst.loc.voc:m3
CBSy	CBS	subst:pl:nom.acc.voc:m3
CBSu	CBS	subst:sg:gen:m3
CBSów	CBS	subst:pl:gen:m3
CBSowi	CBS	subst:sg:dat:m3
CBSom	CBS	subst:pl:dat:m3
CBSie	CBS	subst:sg:voc:m3
CBSie	CBS	subst:sg:loc:m3
CBSem	CBS	subst:sg:inst:m3
CBS	CBS	subst:sg.pl:nom.gen.dat.acc.inst.loc.voc:n:ncol
CBS	CBS	subst:sg:nom.acc:m3
CBSami	CBS	subst:pl:inst:m3
CBSach	CBS	subst:pl:loc:m3
CBOSy	CBOS	subst:pl:nom.acc.voc:m3
CBOSu	CBOS	subst:sg:gen:m3
CBOSów	CBOS	subst:pl:gen:m3
CBOSowi	CBOS	subst:sg:dat:m3
CBOSom	CBOS	subst:pl:dat:m3
CBOSie	CBOS	subst:sg:voc:m3
CBOSie	CBOS	subst:sg:loc:m3
CBOSem	CBOS	subst:sg:inst:m3
CBOS	CBOS	subst:sg.pl:nom.gen.dat.acc.inst.loc.voc:n:ncol
CBOS	CBOS	subst:sg:nom.acc:m3
CBOSami	CBOS	subst:pl:inst:m3
CBOSach	CBOS	subst:pl:loc:m3
CAMy	CAM	subst:pl:nom.acc.voc:m3
CAMu	CAM	subst:sg:gen:m3
CAMów	CAM	subst:pl:gen:m3
CAMowi	CAM	subst:sg:dat:m3
CAMom	CAM	subst:pl:dat:m3
CAMie	CAM	subst:sg:voc:m3
CAMie	CAM	subst:sg:loc:m3
CAMem	CAM	subst:sg:inst:m3
CAM	CAM	subst:sg.pl:nom.gen.dat.acc.inst.loc.voc:m3
CAM	CAM	subst:sg:nom.acc:m3
CAMami	CAM	subst:pl:inst:m3
CAMach	CAM	subst:pl:loc:m3
CAFy	CAF	subst:pl:nom.acc.voc:m3
CAFu	CAF	subst:sg:gen:m3
CAFów	CAF	subst:pl:gen:m3
CAFowi	CAF	subst:sg:dat:m3
CAFom	CAF	subst:pl:dat:m3
CAFie	CAF	subst:sg:voc:m3
CAFie	CAF	subst:sg:loc:m3
CAFem	CAF	subst:sg:inst:m3
CAF	CAF	subst:sg:nom.acc:m3
CAFami	CAF	subst:pl:inst:m3
CAFach	CAF	subst:pl:loc:m3
CADzie	CAD	subst:sg:voc:m3
CADzie	CAD	subst:sg:loc:m3
CADy	CAD	subst:pl:nom.acc.voc:m3
CADu	CAD	subst:sg:gen:m3
CADów	CAD	subst:pl:gen:m3
CADowi	CAD	subst:sg:dat:m3
CADom	CAD	subst:pl:dat:m3
CADem	CAD	subst:sg:inst:m3
CAD	CAD	subst:sg.pl:nom.gen.dat.acc.inst.loc.voc:m3
CAD	CAD	subst:sg:nom.acc:m3
CADami	CAD	subst:pl:inst:m3
CADach	CAD	subst:pl:loc:m3
CADa	CAD	subst:sg:gen:m3
C	C	subst:sg.pl:nom.gen.dat.acc.inst.loc.voc:n:ncol
C	C	subst:sg.pl:nom.gen.dat.acc.inst.loc.voc:m3
BZy	BZ	subst:pl:nom.acc.voc:m3
BZu	BZ	subst:sg:gen:m3
BZów	BZ	subst:pl:gen:m3
BZowi	BZ	subst:sg:dat:m3
BZom	BZ	subst:pl:dat:m3
BZety	BZ	subst:pl:nom.acc.voc:m3
BZetu	BZ	subst:sg:gen:m3
BZetów	BZ	subst:pl:gen:m3
BZetowi	BZ	subst:sg:dat:m3
BZetom	BZ	subst:pl:dat:m3
BZetem	BZ	subst:sg:inst:m3
BZetami	BZ	subst:pl:inst:m3
BZetach	BZ	subst:pl:loc:m3
BZem	BZ	subst:sg:inst:m3
BZecie	BZ	subst:sg:voc:m3
BZecie	BZ	subst:sg:loc:m3
BZ	BZ	subst:sg:nom.acc:m3
BZami	BZ	subst:pl:inst:m3
BZach	BZ	subst:pl:loc:m3
BWZy	BWZ	subst:pl:nom.acc.voc:m3
BWZu	BWZ	subst:sg:gen:m3
BWZów	BWZ	subst:pl:gen:m3
BWZowi	BWZ	subst:sg:dat:m3
BWZom	BWZ	subst:pl:dat:m3
BWZety	BWZ	subst:pl:nom.acc.voc:m3
BWZetu	BWZ	subst:sg:gen:m3
BWZetów	BWZ	subst:pl:gen:m3
BWZetowi	BWZ	subst:sg:dat:m3
BWZetom	BWZ	subst:pl:dat:m3
BWZetem	BWZ	subst:sg:inst:m3
BWZetami	BWZ	subst:pl:inst:m3
BWZetach	BWZ	subst:pl:loc:m3
BWZem	BWZ	subst:sg:inst:m3
BWZecie	BWZ	subst:sg:voc:m3
BWZecie	BWZ	subst:sg:loc:m3
BWZ	BWZ	subst:sg.pl:nom.gen.dat.acc.inst.loc.voc:n:ncol
BWZ	BWZ	subst:sg:nom.acc:m3
BWZami	BWZ	subst:pl:inst:m3
BWZach	BWZ	subst:pl:loc:m3
BWE	BWE	subst:sg.pl:nom.gen.dat.acc.inst.loc.voc:n:ncol
BWE	BWE	subst:sg.pl:nom.gen.dat.acc.inst.loc.voc:m3
BW	BW	subst:sg.pl:nom.gen.dat.acc.inst.loc.voc:n:ncol
BW	BW	subst:sg.pl:nom.gen.dat.acc.inst.loc.voc:m3
BUWy	BUW	subst:pl:nom.acc.voc:m3
BUWu	BUW	subst:sg:gen:m3
BUWów	BUW	subst:pl:gen:m3
BUWowi	BUW	subst:sg:dat:m3
BUWom	BUW	subst:pl:dat:m3
BUWie	BUW	subst:sg:voc:m3
BUWie	BUW	subst:sg:loc:m3
BUWem	BUW	subst:sg:inst:m3
BUW	BUW	subst:sg.pl:nom.gen.dat.acc.inst.loc.voc:f
BUW	BUW	subst:sg:nom.acc:m3
BUWami	BUW	subst:pl:inst:m3
BUWach	BUW	subst:pl:loc:m3
BŚu	BŚ	subst:sg:voc:m3
BŚu	BŚ	subst:sg:loc:m3
BŚu	BŚ	subst:sg:gen:m3
BŚów	BŚ	subst:pl:gen:m3
BŚowi	BŚ	subst:sg:dat:m3
BŚom	BŚ	subst:pl:dat:m3
BŚem	BŚ	subst:sg:inst:m3
BŚe	BŚ	subst:pl:nom.acc.voc:m3
BŚ	BŚ	subst:sg:nom.acc:m3
BŚami	BŚ	subst:pl:inst:m3
BŚach	BŚ	subst:pl:loc:m3
BSRze	BSR	subst:sg:voc:m3
BSRze	BSR	subst:sg:loc:m3
BSRy	BSR	subst:pl:nom.acc.voc:m3
BSRu	BSR	subst:sg:gen:m3
BSRów	BSR	subst:pl:gen:m3
BSRowi	BSR	subst:sg:dat:m3
BSRom	BSR	subst:pl:dat:m3
BSRem	BSR	subst:sg:inst:m3
BSR	BSR	subst:sg:nom.acc:m3
BSRami	BSR	subst:pl:inst:m3
BSRach	BSR	subst:pl:loc:m3
BSP	BSP:s2	subst:sg.pl:nom.gen.dat.acc.inst.loc.voc:n:ncol
BSP	BSP:s2	subst:sg.pl:nom.gen.dat.acc.inst.loc.voc:f
BSP	BSP:s1	subst:sg.pl:nom.gen.dat.acc.inst.loc.voc:n:ncol
BSP	BSP:s1	subst:sg.pl:nom.gen.dat.acc.inst.loc.voc:m3
BSK	BSK	subst:sg.pl:nom.gen.dat.acc.inst.loc.voc:n:ncol
BSK	BSK	subst:sg.pl:nom.gen.dat.acc.inst.loc.voc:m3
BSE	BSE	subst:sg.pl:nom.gen.dat.acc.inst.loc.voc:n:ncol
BSA	BSA	subst:sg.pl:nom.gen.dat.acc.inst.loc.voc:n:ncol
BSy	BS	subst:pl:nom.acc.voc:m3
BSu	BS	subst:sg:gen:m3
BSów	BS	subst:pl:gen:m3
BSowi	BS	subst:sg:dat:m3
BSom	BS	subst:pl:dat:m3
BSie	BS	subst:sg:voc:m3
BSie	BS	subst:sg:loc:m3
BSem	BS	subst:sg:inst:m3
BS	BS	subst:sg:nom.acc:m3
BSami	BS	subst:pl:inst:m3
BSach	BS	subst:pl:loc:m3
BRRze	BRR	subst:sg:voc:m3
BRRze	BRR	subst:sg:loc:m3
BRRy	BRR	subst:pl:nom.acc.voc:m3
BRRu	BRR	subst:sg:gen:m3
BRRów	BRR	subst:pl:gen:m3
BRRowi	BRR	subst:sg:dat:m3
BRRom	BRR	subst:pl:dat:m3
BRRem	BRR	subst:sg:inst:m3
BRR	BRR	subst:sg:nom.acc:m3
BRRami	BRR	subst:pl:inst:m3
BRRach	BRR	subst:pl:loc:m3
BRE	BRE	subst:sg.pl:nom.gen.dat.acc.inst.loc.voc:n:ncol
BRE	BRE	subst:sg.pl:nom.gen.dat.acc.inst.loc.voc:m3
BRBMy	BRBM	subst:pl:nom.acc.voc:m3
BRBMu	BRBM	subst:sg:gen:m3
BRBMów	BRBM	subst:pl:gen:m3
BRBMowi	BRBM	subst:sg:dat:m3
BRBMom	BRBM	subst:pl:dat:m3
BRBMie	BRBM	subst:sg:voc:m3
BRBMie	BRBM	subst:sg:loc:m3
BRBMem	BRBM	subst:sg:inst:m3
BRBM	BRBM	subst:sg:nom.acc:m3
BRBMami	BRBM	subst:pl:inst:m3
BRBMach	BRBM	subst:pl:loc:m3
BRze	BR	subst:sg:voc:m3
BRze	BR	subst:sg:loc:m3
BRy	BR	subst:pl:nom.acc.voc:m3
BRu	BR	subst:sg:gen:m3
BRów	BR	subst:pl:gen:m3
BRowi	BR	subst:sg:dat:m3
BRom	BR	subst:pl:dat:m3
BRem	BR	subst:sg:inst:m3
BR	BR	subst:sg:nom.acc:m3
BRami	BR	subst:pl:inst:m3
BRach	BR	subst:pl:loc:m3
BP	BP:s5	subst:sg.pl:nom.gen.dat.acc.inst.loc.voc:n:ncol
BP	BP:s5	subst:sg.pl:nom.gen.dat.acc.inst.loc.voc:f
BP	BP:s1	subst:sg.pl:nom.gen.dat.acc.inst.loc.voc:n:ncol
BP	BP:s1	subst:sg.pl:nom.gen.dat.acc.inst.loc.voc:m3
BPSy	BPS	subst:pl:nom.acc.voc:m3
BPSu	BPS	subst:sg:gen:m3
BPSów	BPS	subst:pl:gen:m3
BPSowi	BPS	subst:sg:dat:m3
BPSom	BPS	subst:pl:dat:m3
BPSie	BPS	subst:sg:voc:m3
BPSie	BPS	subst:sg:loc:m3
BPSem	BPS	subst:sg:inst:m3
BPS	BPS	subst:sg:nom.acc:m3
BPSami	BPS	subst:pl:inst:m3
BPSach	BPS	subst:pl:loc:m3
BPH	BPH	subst:sg.pl:nom.gen.dat.acc.inst.loc.voc:n:ncol
BPH	BPH	subst:sg.pl:nom.gen.dat.acc.inst.loc.voc:m3
BOŚu	BOŚ	subst:sg:voc:m3
BOŚu	BOŚ	subst:sg:loc:m3
BOŚu	BOŚ	subst:sg:gen:m3
BOŚów	BOŚ	subst:pl:gen:m3
BOŚowi	BOŚ	subst:sg:dat:m3
BOŚom	BOŚ	subst:pl:dat:m3
BOŚem	BOŚ	subst:sg:inst:m3
BOŚe	BOŚ	subst:pl:nom.acc.voc:m3
BOŚ	BOŚ	subst:sg:nom.acc:m3
BOŚami	BOŚ	subst:pl:inst:m3
BOŚach	BOŚ	subst:pl:loc:m3
BOSy	BOS	subst:pl:nom.acc.voc:m3
BOSu	BOS	subst:sg:gen:m3
BOSów	BOS	subst:pl:gen:m3
BOSowi	BOS	subst:sg:dat:m3
BOSom	BOS	subst:pl:dat:m3
BOSie	BOS	subst:sg:voc:m3
BOSie	BOS	subst:sg:loc:m3
BOSem	BOS	subst:sg:inst:m3
BOS	BOS	subst:sg.pl:nom.gen.dat.acc.inst.loc.voc:n:ncol
BOS	BOS	subst:sg:nom.acc:m3
BOSami	BOS	subst:pl:inst:m3
BOSach	BOS	subst:pl:loc:m3
BORze	BOR	subst:sg:voc:m3
BORze	BOR	subst:sg:loc:m3
BORy	BOR	subst:pl:nom.acc.voc:m3
BORu	BOR	subst:sg:gen:m3
BORów	BOR	subst:pl:gen:m3
BORowi	BOR	subst:sg:dat:m3
BORom	BOR	subst:pl:dat:m3
BORem	BOR	subst:sg:inst:m3
BOR	BOR	subst:sg:nom.acc:m3
BORami	BOR	subst:pl:inst:m3
BORach	BOR	subst:pl:loc:m3
BNy	BN	subst:pl:nom.acc.voc:m3
BNu	BN	subst:sg:gen:m3
BNów	BN	subst:pl:gen:m3
BNowi	BN	subst:sg:dat:m3
BNom	BN	subst:pl:dat:m3
BNie	BN	subst:sg:voc:m3
BNie	BN	subst:sg:loc:m3
BNem	BN	subst:sg:inst:m3
BN	BN	subst:sg:nom.acc:m3
BNami	BN	subst:pl:inst:m3
BNach	BN	subst:pl:loc:m3
BMW	BMW	subst:sg.pl:nom.gen.dat.acc.inst.loc.voc:n:ncol
BMW	BMW	subst:sg.pl:nom.gen.dat.acc.inst.loc.voc:m3
BJoty	BJ	subst:pl:nom.acc.voc:m3
BJotu	BJ	subst:sg:gen:m3
BJotów	BJ	subst:pl:gen:m3
BJotowi	BJ	subst:sg:dat:m3
BJotom	BJ	subst:pl:dat:m3
BJotem	BJ	subst:sg:inst:m3
BJotami	BJ	subst:pl:inst:m3
BJotach	BJ	subst:pl:loc:m3
BJocie	BJ	subst:sg:voc:m3
BJocie	BJ	subst:sg:loc:m3
BJ	BJ	subst:sg.pl:nom.gen.dat.acc.inst.loc.voc:f
BJ	BJ	subst:sg:nom.acc:m3
BISE	BISE	subst:sg.pl:nom.gen.dat.acc.inst.loc.voc:n:ncol
BISE	BISE	subst:sg.pl:nom.gen.dat.acc.inst.loc.voc:m3
BIOSy	BIOS	subst:pl:nom.acc.voc:m3
BIOSu	BIOS	subst:sg:gen:m3
BIOSów	BIOS	subst:pl:gen:m3
BIOSowi	BIOS	subst:sg:dat:m3
BIOSom	BIOS	subst:pl:dat:m3
BIOSie	BIOS	subst:sg:voc:m3
BIOSie	BIOS	subst:sg:loc:m3
BIOSem	BIOS	subst:sg:inst:m3
BIOS	BIOS	subst:sg:nom.acc:m3
BIOSami	BIOS	subst:pl:inst:m3
BIOSach	BIOS	subst:pl:loc:m3
BIGu	BIG	subst:sg:voc:m3
BIGu	BIG	subst:sg:loc:m3
BIGu	BIG	subst:sg:gen:m3
BIGów	BIG	subst:pl:gen:m3
BIGowi	BIG	subst:sg:dat:m3
BIGom	BIG	subst:pl:dat:m3
BIGiem	BIG	subst:sg:inst:m3
BIGi	BIG	subst:pl:nom.acc.voc:m3
BIG	BIG	subst:sg:nom.acc:m3
BIGami	BIG	subst:pl:inst:m3
BIGach	BIG	subst:pl:loc:m3
BHP	BHP	subst:sg.pl:nom.gen.dat.acc.inst.loc.voc:n:ncol
BHK	BHK	subst:sg.pl:nom.gen.dat.acc.inst.loc.voc:n:ncol
BHK	BHK	subst:sg.pl:nom.gen.dat.acc.inst.loc.voc:m3
BH	BH	subst:sg.pl:nom.gen.dat.acc.inst.loc.voc:n:ncol
BH	BH	subst:sg.pl:nom.gen.dat.acc.inst.loc.voc:m3
BGŻy	BGŻ	subst:pl:nom.acc.voc:m3
BGŻu	BGŻ	subst:sg:gen:m3
BGŻów	BGŻ	subst:pl:gen:m3
BGŻowi	BGŻ	subst:sg:dat:m3
BGŻom	BGŻ	subst:pl:dat:m3
BGŻety	BGŻ	subst:pl:nom.acc.voc:m3
BGŻetu	BGŻ	subst:sg:gen:m3
BGŻetów	BGŻ	subst:pl:gen:m3
BGŻetowi	BGŻ	subst:sg:dat:m3
BGŻetom	BGŻ	subst:pl:dat:m3
BGŻetem	BGŻ	subst:sg:inst:m3
BGŻetami	BGŻ	subst:pl:inst:m3
BGŻetach	BGŻ	subst:pl:loc:m3
BGŻem	BGŻ	subst:sg:inst:m3
BGŻecie	BGŻ	subst:sg:voc:m3
BGŻecie	BGŻ	subst:sg:loc:m3
BGŻ	BGŻ	subst:sg:nom.acc:m3
BGŻami	BGŻ	subst:pl:inst:m3
BGŻach	BGŻ	subst:pl:loc:m3
BGW	BGW	subst:sg.pl:nom.gen.dat.acc.inst.loc.voc:n:ncol
BGK	BGK	subst:sg.pl:nom.gen.dat.acc.inst.loc.voc:n:ncol
BGK	BGK	subst:sg.pl:nom.gen.dat.acc.inst.loc.voc:m3
BG	BG	subst:sg.pl:nom.gen.dat.acc.inst.loc.voc:n:ncol
BG	BG	subst:sg.pl:nom.gen.dat.acc.inst.loc.voc:m3
BFG	BFG	subst:sg.pl:nom.gen.dat.acc.inst.loc.voc:n:ncol
BFG	BFG	subst:sg.pl:nom.gen.dat.acc.inst.loc.voc:m3
BERDzie	BERD	subst:sg:voc:m3
BERDzie	BERD	subst:sg:loc:m3
BERDy	BERD	subst:pl:nom.acc.voc:m3
BERDów	BERD	subst:pl:gen:m3
BERDowi	BERD	subst:sg:dat:m3
BERDom	BERD	subst:pl:dat:m3
BERDem	BERD	subst:sg:inst:m3
BERD	BERD	subst:sg:nom.acc:m3
BERDami	BERD	subst:pl:inst:m3
BERDach	BERD	subst:pl:loc:m3
BERDa	BERD	subst:sg:gen:m3
BDK	BDK	subst:sg.pl:nom.gen.dat.acc.inst.loc.voc:m3
BCh	BCh	subst:pl:nom.gen.dat.acc.inst.loc.voc:n:pt
BCG	BCG	subst:sg.pl:nom.gen.dat.acc.inst.loc.voc:n:ncol
BCG	BCG	subst:sg.pl:nom.gen.dat.acc.inst.loc.voc:f
BC	BC	subst:sg.pl:nom.gen.dat.acc.inst.loc.voc:m3
BBWRze	BBWR	subst:sg:voc:m3
BBWRze	BBWR	subst:sg:loc:m3
BBWRy	BBWR	subst:pl:nom.acc.voc:m3
BBWRu	BBWR	subst:sg:gen:m3
BBWRów	BBWR	subst:pl:gen:m3
BBWRowi	BBWR	subst:sg:dat:m3
BBWRom	BBWR	subst:pl:dat:m3
BBWRem	BBWR	subst:sg:inst:m3
BBWR	BBWR	subst:sg:nom.acc:m3
BBWRami	BBWR	subst:pl:inst:m3
BBWRach	BBWR	subst:pl:loc:m3
BBK	BBK	subst:sg.pl:nom.gen.dat.acc.inst.loc.voc:n:ncol
BBK	BBK	subst:sg.pl:nom.gen.dat.acc.inst.loc.voc:m3
BBC	BBC	subst:sg.pl:nom.gen.dat.acc.inst.loc.voc:n:ncol
BAVy	BAV	subst:pl:nom.acc.voc:m3
BAVu	BAV	subst:sg:gen:m3
BAVów	BAV	subst:pl:gen:m3
BAVowi	BAV	subst:sg:dat:m3
BAVom	BAV	subst:pl:dat:m3
BAVie	BAV	subst:sg:voc:m3
BAVie	BAV	subst:sg:loc:m3
BAVem	BAV	subst:sg:inst:m3
BAV	BAV	subst:sg.pl:nom.gen.dat.acc.inst.loc.voc:f
BAV	BAV	subst:sg:nom.acc:m3
BAVami	BAV	subst:pl:inst:m3
BAVach	BAV	subst:pl:loc:m3
BASFy	BASF	subst:pl:nom.acc.voc:m3
BASFu	BASF	subst:sg:gen:m3
BASFów	BASF	subst:pl:gen:m3
BASFowi	BASF	subst:sg:dat:m3
BASFom	BASF	subst:pl:dat:m3
BASFie	BASF	subst:sg:voc:m3
BASFie	BASF	subst:sg:loc:m3
BASFem	BASF	subst:sg:inst:m3
BASF	BASF	subst:sg.pl:nom.gen.dat.acc.inst.loc.voc:f
BASF	BASF	subst:sg:nom.acc:m3
BASFami	BASF	subst:pl:inst:m3
BASFach	BASF	subst:pl:loc:m3
BAASy	BAAS	subst:pl:nom.acc.voc:m3
BAASu	BAAS	subst:sg:gen:m3
BAASów	BAAS	subst:pl:gen:m3
BAASowi	BAAS	subst:sg:dat:m3
BAASom	BAAS	subst:pl:dat:m3
BAASie	BAAS	subst:sg:voc:m3
BAASie	BAAS	subst:sg:loc:m3
BAASem	BAAS	subst:sg:inst:m3
BAAS	BAAS	subst:sg.pl:nom.gen.dat.acc.inst.loc.voc:f
BAAS	BAAS	subst:sg:nom.acc:m3
BAASami	BAAS	subst:pl:inst:m3
BAASach	BAAS	subst:pl:loc:m3
BA	BA	subst:sg.pl:nom.gen.dat.acc.inst.loc.voc:n:ncol
AZSy	AZS	subst:pl:nom.acc.voc:m3
AZSu	AZS	subst:sg:gen:m3
AZSów	AZS	subst:pl:gen:m3
AZSowi	AZS	subst:sg:dat:m3
AZSom	AZS	subst:pl:dat:m3
AZSie	AZS	subst:sg:voc:m3
AZSie	AZS	subst:sg:loc:m3
AZSem	AZS	subst:sg:inst:m3
AZS	AZS	subst:sg:nom.acc:m3
AZSami	AZS	subst:pl:inst:m3
AZSach	AZS	subst:pl:loc:m3
AWSy	AWS	subst:pl:nom.acc.voc:m3
AWSu	AWS	subst:sg:gen:m3
AWSów	AWS	subst:pl:gen:m3
AWSowi	AWS	subst:sg:dat:m3
AWSom	AWS	subst:pl:dat:m3
AWSie	AWS	subst:sg:voc:m3
AWSie	AWS	subst:sg:loc:m3
AWSem	AWS	subst:sg:inst:m3
AWS	AWS	subst:sg.pl:nom.gen.dat.acc.inst.loc.voc:f
AWS	AWS	subst:sg:nom.acc:m3
AWSami	AWS	subst:pl:inst:m3
AWSach	AWS	subst:pl:loc:m3
AWFy	AWF	subst:pl:nom.acc.voc:m3
AWFu	AWF	subst:sg:gen:m3
AWFów	AWF	subst:pl:gen:m3
AWFowi	AWF	subst:sg:dat:m3
AWFom	AWF	subst:pl:dat:m3
AWFie	AWF	subst:sg:voc:m3
AWFie	AWF	subst:sg:loc:m3
AWFem	AWF	subst:sg:inst:m3
AWF	AWF	subst:sg.pl:nom.gen.dat.acc.inst.loc.voc:m3
AWF	AWF	subst:sg:nom.acc:m3
AWFami	AWF	subst:pl:inst:m3
AWFach	AWF	subst:pl:loc:m3
ATT	ATT	subst:sg.pl:nom.gen.dat.acc.inst.loc.voc:n:ncol
ATP	ATP	subst:sg.pl:nom.gen.dat.acc.inst.loc.voc:n:ncol
ATP	ATP	subst:sg.pl:nom.gen.dat.acc.inst.loc.voc:m3
ATK	ATK	subst:sg.pl:nom.gen.dat.acc.inst.loc.voc:n:ncol
ATK	ATK	subst:sg.pl:nom.gen.dat.acc.inst.loc.voc:f
ASRze	ASR	subst:sg:voc:m3
ASRze	ASR	subst:sg:loc:m3
ASRy	ASR	subst:pl:nom.acc.voc:m3
ASRu	ASR	subst:sg:gen:m3
ASRów	ASR	subst:pl:gen:m3
ASRowi	ASR	subst:sg:dat:m3
ASRom	ASR	subst:pl:dat:m3
ASRem	ASR	subst:sg:inst:m3
ASR	ASR	subst:sg:nom.acc:m3
ASRami	ASR	subst:pl:inst:m3
ASRach	ASR	subst:pl:loc:m3
ASP	ASP	subst:sg.pl:nom.gen.dat.acc.inst.loc.voc:f
ASEANy	ASEAN	subst:pl:nom.acc.voc:m3
ASEANu	ASEAN	subst:sg:gen:m3
ASEANów	ASEAN	subst:pl:gen:m3
ASEANowi	ASEAN	subst:sg:dat:m3
ASEANom	ASEAN	subst:pl:dat:m3
ASEANie	ASEAN	subst:sg:voc:m3
ASEANie	ASEAN	subst:sg:loc:m3
ASEANem	ASEAN	subst:sg:inst:m3
ASEAN	ASEAN	subst:sg:nom.acc:m3
ASEANami	ASEAN	subst:pl:inst:m3
ASEANach	ASEAN	subst:pl:loc:m3
ASCII	ASCII	subst:sg.pl:nom.gen.dat.acc.inst.loc.voc:m3
ARiMRze	ARiMR	subst:sg:voc:m3
ARiMRze	ARiMR	subst:sg:loc:m3
ARiMRy	ARiMR	subst:pl:nom.acc.voc:m3
ARiMRu	ARiMR	subst:sg:gen:m3
ARiMRów	ARiMR	subst:pl:gen:m3
ARiMRowi	ARiMR	subst:sg:dat:m3
ARiMRom	ARiMR	subst:pl:dat:m3
ARiMRem	ARiMR	subst:sg:inst:m3
ARiMR	ARiMR	subst:sg.pl:nom.gen.dat.acc.inst.loc.voc:f
ARiMR	ARiMR	subst:sg:nom.acc:m3
ARiMRami	ARiMR	subst:pl:inst:m3
ARiMRach	ARiMR	subst:pl:loc:m3
ARze	AR	subst:sg:voc:m3
ARze	AR	subst:sg:loc:m3
ARy	AR	subst:pl:nom.acc.voc:m3
ARu	AR	subst:sg:gen:m3
ARów	AR	subst:pl:gen:m3
ARowi	AR	subst:sg:dat:m3
ARom	AR	subst:pl:dat:m3
ARem	AR	subst:sg:inst:m3
AR	AR	subst:sg.pl:nom.gen.dat.acc.inst.loc.voc:f
AR	AR	subst:sg:nom.acc:m3
ARami	AR	subst:pl:inst:m3
ARach	AR	subst:pl:loc:m3
AP	AP:s2	subst:sg.pl:nom.gen.dat.acc.inst.loc.voc:f
AP	AP:s1	subst:sg.pl:nom.gen.dat.acc.inst.loc.voc:n:ncol
AP	AP:s1	subst:sg.pl:nom.gen.dat.acc.inst.loc.voc:f
APSy	APS	subst:pl:nom.acc.voc:m3
APSu	APS	subst:sg:gen:m3
APSów	APS	subst:pl:gen:m3
APSowi	APS	subst:sg:dat:m3
APSom	APS	subst:pl:dat:m3
APSie	APS	subst:sg:voc:m3
APSie	APS	subst:sg:loc:m3
APSem	APS	subst:sg:inst:m3
APS	APS	subst:sg.pl:nom.gen.dat.acc.inst.loc.voc:m3
APS	APS	subst:sg:nom.acc:m3
APSami	APS	subst:pl:inst:m3
APSach	APS	subst:pl:loc:m3
API	API	subst:sg.pl:nom.gen.dat.acc.inst.loc.voc:m3
APy	APA	subst:sg:gen:f
APy	APA	subst:pl:nom.acc.voc:f
APom	APA	subst:pl:dat:f
APo	APA	subst:sg:voc:f
APie	APA	subst:sg:dat.loc:f
APę	APA	subst:sg:acc:f
APą	APA	subst:sg:inst:f
AP	APA	subst:pl:gen:f
APami	APA	subst:pl:inst:f
APach	APA	subst:pl:loc:f
APA	APA	subst:sg:nom:f
AONy	AON	subst:pl:nom.acc.voc:m3
AONu	AON	subst:sg:gen:m3
AONów	AON	subst:pl:gen:m3
AONowi	AON	subst:sg:dat:m3
AONom	AON	subst:pl:dat:m3
AONie	AON	subst:sg:voc:m3
AONie	AON	subst:sg:loc:m3
AONem	AON	subst:sg:inst:m3
AON	AON	subst:sg.pl:nom.gen.dat.acc.inst.loc.voc:f
AON	AON	subst:sg:nom.acc:m3
AONami	AON	subst:pl:inst:m3
AONach	AON	subst:pl:loc:m3
ANSI	ANSI	subst:sg.pl:nom.gen.dat.acc.inst.loc.voc:n:ncol
ANSI	ANSI	subst:sg.pl:nom.gen.dat.acc.inst.loc.voc:m3
ANSy	ANSA	subst:sg:gen:f
ANSy	ANSA	subst:pl:nom.acc.voc:f
ANSom	ANSA	subst:pl:dat:f
ANSo	ANSA	subst:sg:voc:f
ANSie	ANSA	subst:sg:dat.loc:f
ANSę	ANSA	subst:sg:acc:f
ANSą	ANSA	subst:sg:inst:f
ANS	ANSA	subst:pl:gen:f
ANSami	ANSA	subst:pl:inst:f
ANSach	ANSA	subst:pl:loc:f
ANSA	ANSA	subst:sg.pl:nom.gen.dat.acc.inst.loc.voc:f
ANSA	ANSA	subst:sg:nom:f
AMERBANKu	AMERBANK	subst:sg:voc:m3
AMERBANKu	AMERBANK	subst:sg:loc:m3
AMERBANKu	AMERBANK	subst:sg:gen:m3
AMERBANKów	AMERBANK	subst:pl:gen:m3
AMERBANKowi	AMERBANK	subst:sg:dat:m3
AMERBANKom	AMERBANK	subst:pl:dat:m3
AMERBANKiem	AMERBANK	subst:sg:inst:m3
AMERBANKi	AMERBANK	subst:pl:nom.acc.voc:m3
AMERBANKami	AMERBANK	subst:pl:inst:m3
AMERBANK	AMERBANK	subst:sg:nom.acc:m3
AMERBANKach	AMERBANK	subst:pl:loc:m3
AMy	AM	subst:pl:nom.acc.voc:m3
AMu	AM	subst:sg:gen:m3
AMów	AM	subst:pl:gen:m3
AMowi	AM	subst:sg:dat:m3
AMom	AM	subst:pl:dat:m3
AMie	AM	subst:sg:voc:m3
AMie	AM	subst:sg:loc:m3
AMem	AM	subst:sg:inst:m3
AM	AM	subst:sg.pl:nom.gen.dat.acc.inst.loc.voc:f
AM	AM	subst:sg:nom.acc:m3
AMami	AM	subst:pl:inst:m3
AMach	AM	subst:pl:loc:m3
ALu	AL	subst:sg:voc:m3
ALu	AL	subst:sg:loc:m3
ALu	AL	subst:sg:gen:m3
ALowi	AL	subst:sg:dat:m3
ALom	AL	subst:pl:dat:m3
ALi	AL	subst:pl:gen:m3
ALem	AL	subst:sg:inst:m3
ALe	AL	subst:pl:nom.acc.voc:m3
ALami	AL	subst:pl:inst:m3
AL	AL	subst:sg.pl:nom.gen.dat.acc.inst.loc.voc:n:ncol
AL	AL	subst:sg.pl:nom.gen.dat.acc.inst.loc.voc:f
AL	AL	subst:sg:nom.acc:m3
ALach	AL	subst:pl:loc:m3
AK	AK	subst:sg.pl:nom.gen.dat.acc.inst.loc.voc:n:ncol
AK	AK	subst:sg.pl:nom.gen.dat.acc.inst.loc.voc:f
AI	AI:s2	subst:sg.pl:nom.gen.dat.acc.inst.loc.voc:f
AI	AI:s1	subst:sg.pl:nom.gen.dat.acc.inst.loc.voc:n:ncol
AI	AI:s1	subst:sg.pl:nom.gen.dat.acc.inst.loc.voc:f
AIFy	AIF	subst:pl:nom.acc.voc:m3
AIFu	AIF	subst:sg:gen:m3
AIFów	AIF	subst:pl:gen:m3
AIFowi	AIF	subst:sg:dat:m3
AIFom	AIF	subst:pl:dat:m3
AIFie	AIF	subst:sg:voc:m3
AIFie	AIF	subst:sg:loc:m3
AIFem	AIF	subst:sg:inst:m3
AIFami	AIF	subst:pl:inst:m3
AIF	AIF	subst:sg.pl:nom.gen.dat.acc.inst.loc.voc:f
AIF	AIF	subst:sg:nom.acc:m3
AIFach	AIF	subst:pl:loc:m3
AIDSy	AIDS	subst:pl:nom.acc.voc:m3
AIDSy	AIDS	subst:pl:nom.acc.voc:m2
AIDSu	AIDS	subst:sg:gen:m3
AIDSów	AIDS	subst:pl:gen:m3
AIDSów	AIDS	subst:pl:gen:m2
AIDSowi	AIDS	subst:sg:dat:m3
AIDSowi	AIDS	subst:sg:dat:m2
AIDSom	AIDS	subst:pl:dat:m3
AIDSom	AIDS	subst:pl:dat:m2
AIDSie	AIDS	subst:sg:voc:m3
AIDSie	AIDS	subst:sg:voc:m2
AIDSie	AIDS	subst:sg:loc:m3
AIDSie	AIDS	subst:sg:loc:m2
AIDSem	AIDS	subst:sg:inst:m3
AIDSem	AIDS	subst:sg:inst:m2
AIDSami	AIDS	subst:pl:inst:m3
AIDSami	AIDS	subst:pl:inst:m2
AIDS	AIDS	subst:sg.pl:nom.gen.dat.acc.inst.loc.voc:n:ncol
AIDS	AIDS	subst:sg.pl:nom.gen.dat.acc.inst.loc.voc:m3
AIDS	AIDS	subst:sg:nom:m2
AIDS	AIDS	subst:sg:nom.acc:m3
AIDSach	AIDS	subst:pl:loc:m3
AIDSach	AIDS	subst:pl:loc:m2
AIDSa	AIDS	subst:sg:gen:m2
AIDSa	AIDS	subst:sg:gen.acc:m2
AGH	AGH	subst:sg.pl:nom.gen.dat.acc.inst.loc.voc:n:ncol
AGH	AGH	subst:sg.pl:nom.gen.dat.acc.inst.loc.voc:f
AGD	AGD	subst:pl:nom.gen.dat.acc.inst.loc.voc:n:pt
AFP	AFP	subst:sg.pl:nom.gen.dat.acc.inst.loc.voc:n:ncol
AFP	AFP	subst:sg.pl:nom.gen.dat.acc.inst.loc.voc:f
AFy	AF	subst:pl:nom.acc.voc:m3
AFu	AF	subst:sg:gen:m3
AFów	AF	subst:pl:gen:m3
AFowi	AF	subst:sg:dat:m3
AFom	AF	subst:pl:dat:m3
AFie	AF	subst:sg:voc:m3
AFie	AF	subst:sg:loc:m3
AFem	AF	subst:sg:inst:m3
AFami	AF	subst:pl:inst:m3
AF	AF	subst:sg.pl:nom.gen.dat.acc.inst.loc.voc:f
AF	AF	subst:sg:nom.acc:m3
AFach	AF	subst:pl:loc:m3
ADP	ADP	subst:sg.pl:nom.gen.dat.acc.inst.loc.voc:n:ncol
ADP	ADP	subst:sg.pl:nom.gen.dat.acc.inst.loc.voc:m3
ADNy	ADN	subst:pl:nom.acc.voc:m3
ADNu	ADN	subst:sg:gen:m3
ADNów	ADN	subst:pl:gen:m3
ADNowi	ADN	subst:sg:dat:m3
ADNom	ADN	subst:pl:dat:m3
ADNie	ADN	subst:sg:voc:m3
ADNie	ADN	subst:sg:loc:m3
ADNem	ADN	subst:sg:inst:m3
ADNami	ADN	subst:pl:inst:m3
ADN	ADN	subst:sg.pl:nom.gen.dat.acc.inst.loc.voc:f
ADN	ADN	subst:sg:nom.acc:m3
ADNach	ADN	subst:pl:loc:m3
ADMy	ADM	subst:pl:nom.acc.voc:m3
ADMu	ADM	subst:sg:gen:m3
ADMów	ADM	subst:pl:gen:m3
ADMowi	ADM	subst:sg:dat:m3
ADMom	ADM	subst:pl:dat:m3
ADMie	ADM	subst:sg:voc:m3
ADMie	ADM	subst:sg:loc:m3
ADMem	ADM	subst:sg:inst:m3
ADMami	ADM	subst:pl:inst:m3
ADM	ADM	subst:sg.pl:nom.gen.dat.acc.inst.loc.voc:f
ADM	ADM	subst:sg:nom.acc:m3
ADMach	ADM	subst:pl:loc:m3
AC	AC	subst:sg.pl:nom.gen.dat.acc.inst.loc.voc:n:ncol
ABSy	ABS	subst:pl:nom.acc.voc:m3
ABSu	ABS	subst:sg:gen:m3
ABSów	ABS	subst:pl:gen:m3
ABSowi	ABS	subst:sg:dat:m3
ABSom	ABS	subst:pl:dat:m3
ABSie	ABS	subst:sg:voc:m3
ABSie	ABS	subst:sg:loc:m3
ABSem	ABS	subst:sg:inst:m3
ABSami	ABS	subst:pl:inst:m3
ABSach	ABS	subst:pl:loc:m3
ABS	ABS	subst:sg:nom.acc:m3
ABC	ABC	subst:sg.pl:nom.gen.dat.acc.inst.loc.voc:n:ncol
ABBy	ABBA	subst:sg:gen:f
ABBy	ABBA	subst:pl:nom.acc.voc:f
ABBom	ABBA	subst:pl:dat:f
ABBo	ABBA	subst:sg:voc:f
ABBie	ABBA	subst:sg:dat.loc:f
ABBę	ABBA	subst:sg:acc:f
ABBą	ABBA	subst:sg:inst:f
ABBami	ABBA	subst:pl:inst:f
ABBach	ABBA	subst:pl:loc:f
ABB	ABBA	subst:pl:gen:f
ABBA	ABBA	subst:sg:nom:f
ABB	ABB	subst:sg.pl:nom.gen.dat.acc.inst.loc.voc:n:ncol
AA	AA:s2	subst:sg.pl:nom.gen.dat.acc.inst.loc.voc:n:ncol
AA	AA:s2	subst:sg.pl:nom.gen.dat.acc.inst.loc.voc:m3
AA	AA:s1	subst:pl:nom.gen.dat.acc.inst.loc.voc:m1:pt
AAP	AAP	subst:sg.pl:nom.gen.dat.acc.inst.loc.voc:f
