Bandtkie	pl
Jokai	hu
Jókai	hu
Linde	de-pl
Radetzky	de
Tagore	en
scrabble	en
Kayah	en
manicure	fr
Greenpeace	en
Google	en
Resnais	fr
Rabelais	fr
Marchais	fr
Beaumarchais	fr
Barrès	fr
Updike	en
Locke	en
Drake	en
Brooke	en
Blake	en
Doumergue	fr
Desargues	fr
Panofsky	en
Gracq	fr
Jacques	fr
Haq	fr
Remarque	fr
Braque	fr
Jaques	fr
Aujeszky	hu
Richelieu	fr
Montesquieu	fr
Depardieu	fr
McCartney	en
May	en
Macaulay	en
Losey	en
Kodaly	hu
Jarossy	hu
Huxley	en
Hunyady	hu
Horthy	hu
Hemingway	en
Heaney	en
Halley	en
Goya	es
Gay	en
Faraday	en
Dunaway	en
Disney	en
Boy	en
Berkeley:s2	en
Andrássy	hu
Mérimée	fr
Valéry	fr
Tracy	en
Sotheby	en
Peguy	fr
Montgomery:s2	en
Mercury	en
MacCarthy	en
Larry	en
Kennedy	en
Jimmy	en
Jarry	fr
Henry	en
Harry	en
Hardy:s2	en
Galsworthy	en
Exupéry	fr
Dolphy	fr
Debussy	fr
Connery	en
Bradbury	en
yuppie	en
yuppi	en
hippie	en
d’Estaing	fr
Searle	en
Nightingale	en
Montaigne	fr
Lisle	fr
Joule	fr
Hubble	en
George:s1	en
Gaulle	fr
Gable	en
Doyle	en
Delavigne	fr
Corneille	fr
Constable	en
Braille	fr
Boyle	en
Bourdelle	fr
Georges	fr
Charles:s2	en
Faure:s2	fr
Deneuve:s1	fr
Daisne	fr
Daguerre	fr
Cruise	en
Claude	fr
Christophe	fr
Cezanne	fr
Capote	en
Burne	en
Bruce	en
Brantôme	fr
Bernadotte	fr
Benveniste	fr
Bellonte	fr
Baudelaire	fr
Astaire	fr
Aristide	fr
Apollinaire	fr
Ampére	fr
Ingres	fr
Gennes	fr
Descartes	fr
Delibes	fr
Costes	fr
Barthes	fr
głasnost	ru
Gandhi	en
Jiři	cz
Brâncuşi	ro
Raleigh	en
playboy	en
oldboy	en
jockey	en
cowboy	en
cockney:s2	en
boy	en
Zápolya	hu
Winfrey	en
Thackeray	en
Stanley	en
Sisley	en
Shelley	en
Selye	hu
Presley	en
Ormandy	hu
Nagy	hu
Willy	en
Lundegårdh	sv
Cerha	de
Matisse	fr
Marlowe	en
Magritte	fr
Lumiere	fr
Livingstone	en
Lefebvre	fr
Leconte	fr
Lawrence:s1	en
Larousse	fr
Lamartine	fr
Laine	en
Joyce	en
Jarre	fr
Irvine	en
Gide	fr
Ghelderode	fr
France	fr
Forsythe	en
Fontaine	fr
Fayette	fr
Orszagh	hu
Gogh	nl
Agha	tr
Saldanha	pt
Minh:s2	vi
Verne	fr
Verlaine	fr
Tate	en
Taine	fr
Swinburne	en
Stowe	en
Stone	en
Shakespeare	en
Saussure	fr
Sartre	fr
Sade	fr
Robespierre	fr
Redgrave	en
Racine	fr
Pierre	fr
Morse	en
Moore	en
Monroe	en
Moliére	fr
Milne	en
ninja	ja
sirocco	it
freestyle	en
dodge	en
chippendale:s1	en
branle	fr
longplay	en
jersey:s2	en
harley	en
bentley	en
rolls-royce	en
iphone	en
courante	fr
breakdance	en
beguine	fr
anglaise	fr
allemande	fr
ensemble	fr
volley	en
spray	en
speedway	en
runway	en
replay	en
permalloy	en
jersey:s1	en
fairway	en
cockney:s1	en
Broadway	en
Aligarh	en
siècle	fr
rocaille	fr
quiche	fr
joule	fr
image	fr
grunge	en
grisaille	fr
entourage	fr
decoupage	fr
collége	fr
college	en
collage	fr
cartridge	en
assemblage	fr
penthouse	en
pedicure	fr
offside	en
mainframe	en
interface	en
house	en
high-life	en
hate	en
hardware	en
hardcore	en
genre	fr
frimaire	fr
empire	fr
drive	en
deadline	en
brumaire	fr
Montparnasse	fr
Montmartre	fr
Danone	fr
upgrade	en
unicode	en
tricorne	fr
timbre	fr
strip-tease	en
software	en
savoir-vivre	fr
regime	fr
ragtime	en
performance	en
polje	sr
Skopje	mk
Izwiestia	ru
Gillespie	en
Rushdie	en
Christie:s2	en
Barrie	en
Pittsburgh	en
Minh:s1	vi
pudźa	hi
guide	en
Wilde:s1	en
White	en
Wayne	en
Wallace	en
remake	en
boutique	fr
nuraghi	it
Sargodha	ur
derha	pl
Zrínyi	hu
Gaudí	es
villanesca	it
nesca	en
coca	es
carioca	pt
Athabasca	la
Dziubanii	pl
Toynbee	en
Murii	pl
Noji	ja
paparazzo	it
Carnegie	en
Muskie	en
prozac	en
panasonic	en
metallic:s2	en
metallic:s1	en
metalic:s2	en
metalic:s1	en
asdic	en
armagnac	fr
aerobic	en
Quebec	fr
Optiroc	en
Basic	en
Atlantic	en
Vico	it
Tezcatlipoca	es
Sica	en
Poulenc	fr
Mauriac	fr
Marco	it
Lussac	fr
Lorca	es
Leblanc	fr
Lautrec	fr
Greco	es
Fonseca	es
Chirac	fr
Balzac	fr
Angelico	it
pontiac	fr
cadillac	fr
cadilac	fr
Titanic	en
baklava	en
Praha	cz
Java	fr
Inkatha	en
Hertha	de
Nemcova	cz
Garcia	es
casanova	it
Venclova	cz
Laxa	sv
Dixa	en
Jaxa	pl
Casanova	it
Mantegna	it
Botha	nl
Fritza	de
cha-cha	es
lancia	it
pizza	it
felicia	it
dacia	it
welwiczia	pl
glediczia	pl
stanza	it
grandezza	it
berceuse	fr
Bramah	en
Ilja	ru
paria:s2	hi
Moravia	la
Ilia:s1	ru
Borgia	it
Beria	ru
Aria	it
Pardua:s2	it
Joszua	pl
Joshua	en
Jeszua	pl
Jehoszua	pl
Gargantua	pl
plymouth	en
parcours	fr
compact	en
Akademgorodok	ru
Joseph	en
Smith	en
Kenneth	en
Keith	en
Hogarth	en
Hindemith	en
Griffith	en
Galbraith	en
Forsyth	en
Roth	en
Kossuth	hu
Goth	en
rococo	it
lastrico	it
Servisco	en
cornflakes	en
developersko	en
düsseldorfsko	de
écru:d	fr
explicite	la
extra:d	la
göteborsko	sv
harvardzko	en
heavymetalowo	en-pl
hvarsko	hr
liverpoolsko	en
münstersko	de
newage'owo	en-pl
novellowsko	en
oxfordzko	en
quebecko	fr-pl
queerowo	en-pl
qumrańsko	en
reykjavicko	is
rock’n’rollowo	en-pl
saussure’owsko	fr-pl
sexy:d	en
software’owo	en-pl
tête-à-tête	fr
vatowsko	pl
vipowsko	pl
vis-à-vis:d	fr
würzbursko	de
niedevelopersko	en
niedüsseldorfsko	de
niegöteborsko	de
nieharvardzko	en
nieheavymetalowo	en
niehvarsko	hr
nieliverpoolsko	en
niemünstersko	de
nienovellowsko	en
nieoxfordzko	en
niequebecko	fr-pl
niequeerowo	en-pl
niequmrańsko	en
niereykjavicko	is
nierock’n’rollowo	en-pl
niesaussure’owsko	fr-pl
niesoftware’owo	en-pl
nievatowsko	pl
nievipowsko	pl
niewürzbursko	de
ampexowy	en-pl
bouclé:a	fr
brexitowy	en-pl
daviscupowy	en-pl
dell’arte:a	it
developerski	en-pl
düsseldorfski	de-pl
dżinsowy	pl
écru:a	fr
eventowy	en-pl
extra:a	la
frotté:a	fr
göteborski	sv-pl
harvardzki	en-pl
heavymetalowy	en-pl
hvarski	hr-pl
kickboxingowy	en-pl
liverpoolski	en-pl
maxi	en
münsterski	de-pl
newage'owy	en-pl
nieampexowy	en-pl
niedaviscupowy	en-pl
niedeveloperski	en-pl
niedüsseldorfski	de-pl
niegöteborski	de-pl
nieharvardzki	en-pl
nieheavymetalowy	en-pl
niehvarski	hr-pl
niekickboxingowy	en-pl
nieliverpoolski	en-pl
niemünsterski	de-pl
nienewage'owy	en-pl
nienovellowski	en-pl
nieoxfordzki	en-pl
niequadowy	en-pl
niequebecki	fr-pl
niequizowy	en-pl
niequmrański	en-pl
niereykjavicki	is-pl
nierock’n’rollowy	en-pl
niesaussure’owski	fr-pl
niesoftware’owy	en-pl
niesurvivalowy	en-pl
nieunixowy	en-pl
nievatowski	pl
nievipowski	pl
niewürzburski	de-pl
novellowski	en-pl
oxfordzki	en-pl
quadowy	en-pl
quebecki	fr-pl
queerowy	en-pl
quizowy	en-pl
qumrański	en-pl
reykjavicki	is-pl
rock’n’rollowy	en-pl
saussure’owski	fr-pl
sauté	fr
sexy:a	en
software’owy	en-pl
survivalowy	en-pl
unixowy	en-pl
vatowski	pl
video:a	en
vipowski	pl
würzburski	de-pl
accusativus	la
adiectivum	la
adverbium	la
affidavit	la
agrément	fr
aide-mémoire	fr
Ajax	nl
Aladár	es
alvit	pl
ampex	en
ampexowość	en-pl
appendix	la
aquapark	en
assemblé	fr
Asterix	fr
attaché	fr
aval	pl
Avia	cz
Avignon	fr
avocado	es
Avogadro	it
Avraham	he
axel	sv
Aznavour	fr
Beauvoir	fr
becherovka	cz
Beethoven	de-pl
Benelux	fr
blackjack	en
Blixen	nl
bolivar	es
Bolivar	es
boliviano	es
bonvivant	fr
bon-vivant	fr
bordeaux	fr
Bordeaux	fr
bouclé:s	fr
bourrée	fr
Bovary:s1	fr
Bovary:s2	fr
boxing	en
Brâtianu	ro
Brazzaville	fr
Bregović	sr
brexit	en
brexitowość	en-pl
Brontë	en
Brückner	de-pl
Buñuel	es
Buxtehude	de
calvados	es
Calvados	es
Caravaggio	it
caravaggionizm	it
caravan	en
caravaning	en
carving	en
Ceauşescu	ro
centavo	es
Cervantes	es
chargé	fr
Chevalier	fr
cheviot:s1	en
cheviot:s2	en
chevrolet	en
Chomsky	en
cinéma-vérité	fr
cinquecento	it
Cleveland	en
collectivum	la
colloquium	la
Compaq	en
compluvium	la
coniunctivus	la
coupé	fr
cover	en
Cracovia	la
cracoviana	la
Craxi	it
crossing-over	la
curaçao	pt
ćakra	hi
d’Alembert	fr
Däniken	en
d’Annunzio	it
d’Arc	fr
d’Arquien	fr
dativus	la
David	fr
Davies	en
Davis	en
daviscupowość	en-pl
Davos	de
Delacroix	fr
dell’arte:s	it
démarche	fr
Deneuve:s2	fr
Denver	en
désintéressement	fr
developer	en
developerskość	en-pl
devotiomoderna	la
Discovery	en
divertimento	it
divertissement	fr
dixieland	en
driver	en
Dürer	de-pl
Dürrenmatt	de
düsseldorfskość	de-pl
dźataka	hi
dźinizm	hi
écru:s	fr
Elvis	en
entrée	fr
equalizer	en
Essex	en
Esterházy	hu
event	en
Everest	en
evergreen	en
Exbud	pl
Excelsior	la
exemplum	la
exequatur	la
exodos	la
exodus	la
expo	en
exposé	fr
expres	pl
Express	en
exsequatur	la
extranet	en
fauxpas	fr
favela	es
favoritka	cz
fax	en
Fenix	en
fixing	en
floréal	fr
frotté:s	fr
führer	de-pl
Gallux	pl
Galvani	it
genetivus	la
Giraudoux	fr
goretex	en
gore-tex	en
Göteborg	sv
göteborskość	sv-pl
Graves	en
Guevara	es
Günter	de-pl
harlequin	en
Harvard:s1	en
Harvard:s2	en
harvardzkość	en-pl
Havel	cz
heavymetal	en
heavymetalowiec	en-pl
heavymetalowość	en-pl
Hendrix	en
hexastyl	pl
Hitlerjugend	de
Hoover	en
Hortex	la
hvarskość	hr-pl
imperativus	la
impluvium	la
infinitivus	la
Interfax	la
interrex	la
interview	en
iterativum	la
Ivan	ru
Kandinsky	en
katzenjamer	de-pl
katzenjammer	de-pl
Kelvin	en
Kevin	en
kevlar	en
kick-boxer	en
kick-boxing	en
kickboxingowość	en-pl
Kovacz	pl
Ku-Klux-Klan	en
ländler	de
landrover	en
lavabo	la
Lavoisier	fr
leitmotiv	de
lentex	en
Levi	he
lexus	la
Linux	en
Liverpool	en
liverpoolskość	en-pl
locativus	la
Ludvig	de-pl
Lukács	hu
lurex	en
lux	la
luxfer	la
Machiavelli	it
Malmö	sv
Malraux	fr
Marivaux	fr
Marquez	es
matrix	en
Max	de
maxisingel	de
maxwell	en
Maxwell	en
melex	la
Meliés	fr
Merckx	nl
Miloszević	sr
minivan	en
mix	en
Montevideo	es
Münster	de
münsterskość	de-pl
müsli	de
Narvik	nb
nativespeaker	en
Navarra	es
neufchâtel	fr
newage'owość	en-pl
nieampexowość	en-pl
niebrexitowość	en-pl
niedaviscupowość	en-pl
niedeveloperskość	en-pl
niedüsseldorfskość	de-pl
niegöteborskość	de-pl
nieharvardzkość	en-pl
nieheavymetalowość	en-pl
niehvarskość	hr-pl
niekickboxingowość	en-pl
nieliverpoolskość	en-pl
niemünsterskość	de-pl
nienovellowskość	en-pl
nieoxfordzkość	en-pl
niequebeckość	fr-pl
niequeerowość	en-pl
niequizowość	en-pl
niequmrańskość	en-pl
niereykjavickość	is-pl
nierock’n’rollowość	en-pl
niesoczińskość	ka-pl
niesoftware’owość	en-pl
niesurvivalowość	en-pl
nieunixowość	en-pl
nievatowskość	pl
nievipowskość	pl
niewürzburskość	de-pl
Nixon	en
nominativus	la
non-violence	en
Novell	en
novellowskość	en-pl
novum	la
O’Connell	ga
Oliver	en
Olivia	en
Olivier	fr
O’Neill	ga
opéra-ballet	fr
öre	en
overlock	en
oxer	en
Oxford	en
oxfordzkość	en-pl
oxycort	en
passivum	la
Pavarotti	it
Pax	la
PAX	la
peiorativum	la
Pétain	fr
Petőfi	hu
Pewex	pl
pitaval	fr
plexi	en
plexiglas	en
Polgár	hu
pontifex	la
praxis	la
prequel	en
prix	fr
pulque	fr
purée	fr
pyrex	en
quad	en
quadowiec	en-pl
quadriennale	it
quadrivium	la
quantum	la
quasimodo	la
Quasimodo	la
quattrocento	it
quebeckość	fr-pl
quebracho	es
queerowość	en-pl
quetzal	es
quickstep	en
Quinn	en
quipu	es
Quisling	nb
Quito	es
quiz	en
quizowość	en-pl
qumrańskość	en-pl
quodlibet	la
quorum	la
Radovan	sr
randezvous	fr
Ravel	fr
Ravensbrück	de
ravioli	it
recitativo	it
refleksivum	pl
reflexivum	la
rendez-vous	fr
René	fr
requiem	la
résumé	fr
retriever	en
Rex	la
reykjavickość	is-pl
Reykjavik	is
rock’n’roll	en
rock’n’rollowość	en-pl
Roosevelt	en
roquefort	fr
rover	en
Salvador	es
Savonarola	it
sequel	en
sex	la
sex-shop	en
skikjöring	nb
skipjack:s1	en
skipjack:s2	en
slavica	la
slow-fox	en
software’owość	en-pl
soirée	fr
sollux	en
souvenir	fr
squash	en
squat	en
squatter	en
squaw	en
Steven	en
Stevenson	en
Stradivari	it
stradivarius	la
substantivum	la
survival	en
survivalowiec	en-pl
survivalowość	en-pl
śikhara	hi
śiwaizm	hi
śudra	hi
Tanjug	sr
taxi	en
Teleexpress	en
telefax	en
telex	en
tequila	es
Thälmann	de-pl
Thorvaldsen	da
torques	la
tournée	fr
travelling	en
Travolta	it
triplex	la
trivium	la
Universal	en
Unix	en
unixowość	en-pl
vacat	la
vacherin	fr
Vaclav	cz
vademecum	la
validol	la
valpolicella	it
Vancouver:s1	en
Vancouver:s2	en
van:s	en
vaporetto	it
Vargas	es
varia	la
varietes	fr
variétés	fr
varsaviana	la
varsavianista	la
varsavianistka	la
varsavianistyka	la
Vasco	pt
vatermörder	de
vatowiec	pl
vatowskość	pl
vectra	it
vedetta	it
Vega	la
velarium	la
Velazquez	es
vendetta	it
ventôse	fr
Ventzislav	fr
veraikon	la
verbum	la
Verdi	it
Verdun	fr
verlan	fr
Vermeer	nl
Vermont:s1	en
Vermont:s2	en
Veronese	it
Versace	it
verso	la
vertical	en
Vespucci	it
veto	la
Vetulani	it
viagra	la
vibrato	it
Victoria	la
video:s	en
vihuela	es
villanella	it
vina	la
vinaigrette	fr
Vinci	it
vintage	en
viola	it
Violeta	it
Violetta	it
vipowskość	pl
virelai	fr
virement	fr
Virginia	en-pl
vis	fr
vis-à-vis:s	fr
Visconti	it
vivace	it
Vivaldi	it
vivant	fr
vivarium	la
viveur	fr
Vladimir	ru
vlepka	pl
vocativus	la
Vogel	de
Voigt	de
Voit	de
volapük	vo
vol-au-vent	fr
volksdeutsch	de
volkslista	de-pl
volkswagen	de-pl
volt	en
volta	it
Volta	it
volumen	la
volvo	la
vomitorium	la
voodoo	en
votum	la
voucher	en
vouvray	fr
Vranitzky	de
würzburskość	de-pl
xantia	fr-pl
Xawery	pl
Xenia	pl
xero	pl
XML	acro
Xymena	pl
banjo	en
banjola	en
InterCity	en
iPad	en
iPhone	en
iPod	en
JavaScript	en
MacArthur	en
MacDonald	en
McDonald	en
McLuhan	en
bravissimo	it
Vegas	en
vel	la
versus	la
verte	la
via	la
vice	la
vis-à-vis:p	fr
vivat	la
von	de
vulgo	la
vw	de
Abaúj	hu
abbreviatura	la
Abélard	fr
abraxas	el
Abraxas	el
Ærø	da
alax	pl
Aldridge	en
Alexander	pl
Alexandrowicz	pl
Alexis	fr
Almodóvar	es
AltaVista	es
Alvaro	es
Alvarus	la
André	fr
Andy	en
Antioquia	es
appellativum	la
aquaplaning	en
Arequipa	es
Ariège	fr
Atatürk	tr
augmentativum	la
autoexec	en
Avarua	en
avaruański	en-pl
avensis	la
avia	la
aviomarin	la
Axentowicz	pl
Axer	de
azotox	pl
Bács-Kiskun	hu
Barrés	fr
Baxter	en
beatbox	en
Becquerel	fr
beethovenowski	de-pl
Béla	hu
biovital	la
Blanqui	fr
Boavista	es
botox	en
bouclé	fr
Bourvil	fr
Bovary	fr
boxster	en
Brändö	fi
Brasília	pt
Brecqhou	en
Budexpo	pl
Calvin	en
Canaveral	en
Canova	it
Caprivi	it
caravaggionista	it
caravaggionistyczny	it
caravaningowy	en-pl
cardox	en
carnival	en
carvingowy	en-pl
Cassavetes	en
Cavalcanti	ir
Cavalieri	it
Cavalli	it
cavata	la
cavatina	it
Cavendish	en
Caxton	en
Ceará	pt
Charles	en
cheviot	en
chiavetta	it
Chiesanuova	it
chippendale	en
Chongqing	zh
Čiovo	hr
civic	en
conquista	es
Corcovado	pt
Corrèze	fr
Cortés	es
Côte	fr
Côtes	fr
Cotopaxi	es
cultivar	en
Curaçao	pt
curving	en
Cuvier	fr
ćela	hi
darśana	hi
Daugavpils	lv
Davenport	en
Dąbrovia	la
defectivum	la
déjàvue	fr
Delerue	fr
dell’arte	it
deminutivum	la
Deneuve	fr
Devon	en
ditox	en
Dover	en
Duchovna	cz
Duchovny	cz
duralexowy	en-pl
düsseldorfczyk	de
düsseldorfka	de
duumvirat	la
Duval	fr
Duvall	en
dux	la
dźajnizm	hi
dźinijski	hi-pl
dźinista	hi
dźiwanmukta	hi
easyJet	en
eBay	en
eCard	en
Eckerö	fi
écru	fr
Enquist	sv
environment	en
esidrex	en
evanda	en
Evanda	en
Evangelista	it
Evans	en
evasion	en
everyman	en
Evita	es
excelsior	la
expat	en
explorer	en
export	en
expresowy	pl
express	en
expresso	en
Expresso	en
extra	la
Extremadura	es
Fårö	nb
Faurea	fr
faxmodem	en
Fejér	hu
Finistère	fr
Finström	fi
fluidex	en
fluxus	la
Föglö	fi
Fouquet	fr
Franche-Comté	fr
Frédéric	fr
frotté	fr
Fuerteventura	es
Galdhøpiggen	nb
gańdźa	hi
Gaoxiong	zh
Gdovia	la
Gemäldegalerie	de
George	en
Gérard	fr
geriavit	la
gerovital	la
gerundivum	la
Giovanni	it
gjuwecz	bg
Glover	en
Głogovia	la
Goiás	pt
gore	en
Górnovia	la
Gravesen	da
gravis	la
Gregory	en
Grímsvötn	is
Groër	de
Großglockner	de
Großtitlisschanze	de
Grybovia	la
Grytviken	nb
Gudźarat	hi
Günther	de
Gustavia	la
Győr	hu
Hagåtña	ch
Hajdú	hu
Hannover	de
Hardy	en
haridźan	hi
Harvard	en
Harvey	en
Havas	en
Hawai'i	en
Heerenveen	nl
Heilongjiang	zh
Helvetius	la
herbatox	pl
Hévíz	hu
hex	la
hexenmeister	de
Höfuðborgarsvæðið	is
Hoogovens	nl
Hornindalsvatnet	nb
Hōryū	ja
House	en
Hübner	de
Hvannadalshnúkur	is
Hvar	hr
hydrox	en
hydroxizin	en
Hypernova	en
idéefixe	fr
Iguaçu	pt
Île-de-France	fr
inchoativum	la
intavolatura	it
intensivum	la
interrogativum	la
intransitivum	la
invar	en
Invest	en
Irving	en
Iverson	en
jacquemart	fr
jadźńa	hi
Jadźurweda	hi
Jämtland	sv
jaquemart	fr
Järva	et
Järvamaa	et
Jarvis	en
Jász-Nagykun-Szolnok	hu
Javier	ed
Jēkabpils	lv
Jelgava	lv
Ještěd	cz
Jiangxi	zh
Joaquin	es
Jõgeva	et
Jõgevamaa	et
Jouvet	fr
Jovovich	en
jukebox	en
Jūrmala	lv
Kalevipoeg	et
Kangwŏn	ko
Kékes	hu
kickboxing	en
Kīlauea	en
Kíthira	el
kochanoviana	la
Koguryŏ	ko
Köhler	de
Kökar	fi
Komárom	hu
König	de
Korčula	hr
Korvatunturi	fi
Kovacs	hu
Krüger	de
kuponovka	cz
Küttel	de
KwaZulu	zu
Kyŏnggi	ko
Lääne	et
Läänemaa	et
Lääne-Virumaa	et
Lagerkvist	sv
LaSalle	en
Lascaux	fr
Lawrence	en
Laxness	en
Leverkusen	de
Levin	en
Levinas	fr
Levinson	en
Lévi-Strauss	fr
levisy	en
lexmark	en
Libreville	fr
Liepāja	lv
Limanovia	la
livarot	fr
livebox	en
liverpoolczyk	en
liverpoolka	en
Lomé	fr
Lovecraft	en
lumpex	pl
luxomierz	pl
Lysgårdsbakken	nb
maalox	en
MacKay	en
MacLean	en
MacLuhan	en
Macquarie	en
madroxin	en
mahjong	en
Malkovich	en
malström	nb
Manggha	ja
maqam	ar
Marañón	es
Marvell	en
Marvin	en
masmix	pl
Mátra	hu
maverick	en
maxim	en
maxima	la
Maximilian	en
maximum	la
Maxpol	pl
McArthur	en
McCain	en
McCoy	en
McCullers	en
McEwan	en
McKinley	en
McLaughlin	en
McLeod	en
McMillan	en
McNeill	en
McQueen	en
McTiernan	en
Melnox	en
Michoacán	es
Midi-Pyrénées	fr
Mijatović	sr
miralux	la
Moldoveanu	ro
Möller	en
Møn	da
Monteverdi	it
Montgomery	en
Mühlenkopfschanze	de
Mulhacén	es
Müller	de
multivan	en
Multivita	la
Multi-Vita	la
Münchhausen	de
Müritz	de
navara	en
Navassa	en
navicert	en
Navratilova	cz
nervosol	la
Neuchâtel	fr
Nevada	en
Nevis	en
nexia	en
nexus	la
nieavaruański	en-pl
niebeethovenowski	de-pl
niecaravaggionistyczny	it-pl
niecaravaningowy	en-pl
niecarvingowy	en-pl
nieduralexowy	en-pl
niedźinijski	hi-pl
nieexpresowy	pl
nieextra	la
niequeenslandzki	en-pl
niequezoński	es
nierooseveltowski	en-pl
niesexy	en
niesmoothjazzowy	en-pl
nietelexowy	en-pl
nietexarkański	en-pl
nievarsavianistyczny	la-pl
nievilski	la
Nièvre	fr
nievukovarski	hr-pl
Ningxia	zh
Niven	en
Novak	cz
novelletta	it
novial	la
novotel	la
Novotel	la
Nuku'alofa	to
O'ahu	en
Oaxaca	es
octavia	la
Ōkurayama	ja
Onyx	en
Öræfajökull	is
Örebro	sv
Öskjuvatn	is
Östergötland	sv
Østfold	nb
overall	en
overbooking	en
overclocking	en
overdubbing	en
oxazepam	pl
oxeladin	en
oxford	en
Oxfordshire	en
oxyterracyna	pl
Óniseks	pl
Paavo	fi
padovana	it
Padovano	it
Päijänne	fi
paintbox	en
Pál	hu
Pará	pt
Paricutín	pt
Pärnumaa	et
Pavel	cz
pavulon	pl
Paxton	en
Petöfi	hu
pewex	pl
Pierce	en
pocztex	pl
Põlva	et
Popocatépetl	es
Popović	sr
Port-aux-Français	fr
Porto-Novo	es
previa	la
Privatdozent	de
proverbium	la
provider	en
Qinghai	zh
Qiqihar	zh
quap	en
quasi	la
Queensland	en
Queenslandczyk	en
Queenslandka	en
queenslandzki	en-pl
Quentin	en
querela	it
Querétaro	es
quest	en
quezoński	es-pl
Rastislav	cz
Réaumur	fr
reconquista	es
Reeves	en
rex	la
rexton	en
Reykjavík	is
Rēzekne	lv
RheinEnergieStadion	de
rhovyl	en
Ridge	en
rivanol	pl
Riviera	pl
rooseveltowski	en-pl
Rover	en
Roxana	pl
RTV	pl
Safjan	pl
Saint-Barthélemy	fr
Salpausselkä	fi
Saltvik	fi
Samsø	da
Sándor	hu
Sanovia	la
Sansovino	it
saxhorn	en
Schröder	de
sedativa	la
semtex	pl
Service	en
Severn	en
sexy	en
Shaanxi	zh
Shanxi	zh
shire	en
Silver	en
Silvia	en
simplex	en
skate	en
smoothjazzowy	en-pl
Snæfellsjökull	is
Solvay	en
Sør	nb
Soufrière	fr
squatters	en
Stalexport	pl
Stavanger	da
Stavros	el
Stevens	en
Suðurland	is
Suðurnes	is
supernova	la
supervisor	en
Suva	en
Svalbard	nb
Sven	sv
Svensson	sv
Svitlica	sr
Svoboda	cz
Sylvia	pl
Szatmár	hu
śaktyzm	hi
śilpaśastra	hi
tampax	en
Tarnovia	la
tavria	uk
tavrija	uk
telexowy	en-pl
tex	en
texarkański	en-pl
texel	nl
Texel	nl
Thingvallavatn	is
Thorshavn	da
Tommy	en
Topkapı	tr
Torquemada	es
Torvalds	fi
Tórshavn	da
Travis	en
Trevor	en
Triglav	sl
Trøndelag	nb
Tuchovia	la
Tuvalu	en
übermensch	de
Ullevi	sv
unisex	en
univira	la
Vadim	fr
Vaduz	de
Vágar	da
vagina	la
Val	la
Valais	fr
Valentino	it
Valga	et
Valgamaa	et
Valladolid	es
Valletta	mt
Valls	es
valonea	la
van	en
Vancouver	en
Vangelis	pl
Vanuatu	bi
Vanzetti	it
vaquero	es
Vårdö	nb
Varga	pl
variorum	la
Värmland	sv
varsavianistyczny	la
Varsinais	fr
Vas	en
Vasari	it
vaticinium	la
Vaud	fr
vauxhall	en
vegantin	fr
Vegeta	la
Veltins	de
Ven	sv
Venda	en
Vendryes	fr
Vendsyssel	da
venflon	en
venta	la
Ventspils	lv
Vera	la
Veracruz	es
veramid	pl
Verena	de
Verheugen	de
Verhofstadt	nl
Vermont	en
Vest	en
Vestfirðir	is
Vestfold	nb
Vesturland	is
Victor	la
victoria	la
Vidal	en
video	la
videoblog	en
videoclip	en
videotelefon	pl
Vidor	it
Vienne	fr
Vietcong	en
Vijandi	et
Vijay	en
Vikersundbakken	nb
Viktor	de
Vilaine	fr
vilcacora	la
Viljandimaa	et
Villardczycy	fr
Villas	pl
Villon	fr
vilski	pl
Vincent	fr
Vincenz	de
vioform	la
viper	en
virga	la
Viru	et
Virumaa	et
Vis	la
visa	en
Visa	en
vis-à-vis	fr
Vista	en
Vitamed	pl
vitara	en
vitaral	pl
Vitus	la
Vizcaya	es
Vlaminck	nl
vlepkarz	pl
vlog	en
Vogt	de
Vogtlandarena	de
Volker	de
Volkskammer	de
Volkswagen	de
Vonnegut	en
Vorarlberg	de
Vormsi	et
Võru	et
Võrumaa	et
Vossler	de
voyeur	en
voyeuryzm	en
Vredeman	nl
Vries	nl
Vukovar	hr
vukovarski	hr-pl
Vulcano	en
Vuoksi	fi
Vytautas	lt
wajśja	hi
Wallström	sv
Waverley	en
Wilde	en
Xavier	fr
xedos	en
xenia	fr
Xining	zh
Xinjiang	zh
xsara	fr
Yvelines	fr
Zemplén	hu
zovirax	en
Zvezda	ru
Þingvallavatn	is
Þórisvatn	is
unplugged	en
waterproof:a	en
non-iron:a	en
pompadour	fr
fair:a	en
topless:a	en
trendy	en
okay:a	en
jazzy	en
groggy	en
Rilke	de
Reszke	pl
Paszke	pl
Mikke	de
Handke	de
Lange	de
Caprio	it
taiji	zh
rockabilly	en
funky	en
chardonnay	fr
buggy	en
Wembley	en
Sydney	en
Berkeley:s1	en
husky	en
grizzly	en
Courtenay	fr
whisky	en
Nelly	en
sulky	en
hyundai	ko
Giedroyc	pl
facsimile	la
epeisodion	el
Bernoulli	fr
Brunelleschi	it
Bykau	be
Gneisenau	de
Gurkha	en
Landau	de
Rathenau	de
Turnau	de
Newerly	pl
Trubieckoj	ru
Szeptyćkyj	uk
Ossietzky	de
Komensky	cz
Bogorodckij	ru
Wołżskij	ru
Correggio	it
Franz	de
Fritz	de
Glotz	de
Hertz	de
Schulz	de
Waltz	de
Miklosich	de
lutz	de
coach:s2	en
Macintosh	en
slash	en
thrash	en
ersatz	de
Arrow	en
Bellow	en
Longfellow	en
Shaw	en
mirza	ar
murza	ar
Mathea	de-pl
chihuahua	es
putonghua	zh
Gotha	de
Anouilh	fr
Balazs	hu
Bunsch	de
Bush	en
Foch	fr
Frisch	de
Horowitz	de
Krenz	de
Kunz	de
Kutz	de
Leibniz	de
Lelouch	fr
Lorentz	de
Lutz	de
Lynch	en
Meszaros	hu
Nitsch	de
Samaranch	es
Toeplitz	de
Wachholz	de
chow-chow	en
gourde	fr
malinois	fr
mirage	fr
Armagnac	fr
Heathrow	en
make-up	en
one-step	en
peep-show	en
peepshow	en
Bollywood	en
Cambridge	en
Connecticut	en
Hollywood	en
Tesco	en
Tour	fr
Abigail	en
mangrowe	en
tefilim	he
paparazzi	it
maggi	it
duce	it
zombie	en
collie	en
kelpie	en
sheltie	en
porsche	de
back-office	en
brie	fr
chippendale:s2	en
yale	en
shareware	en
steeplechase	en
Beatrice	en
Cardinale:s2	it
Christie:s1	en
Cyrce	la
bule	el
fyle	el
groupie	en
mademoiselle	fr
ratatouille	fr
Delaware:s2	en
Watergate	en
attitude	en
aubade	fr
bouillabaisse	fr
chamedafne	la
duchesse	fr
episteme	el
Seattle	en
boogie-woogie	en
cassate	it
gigolo	it
Chirico	it
Eco	it
Franco	es
Ionesco	ro
gracioso	it
piccolo:s1	it
cruzeiro	pt
Mitchum	en
Czeczott	pl
Narbutt	pl
Poczobutt	pl
Traugutt	pl
Jessica	en
Milhaud	fr
coach:s1	en
kronprinz	de
scotch	en
cicerone	it
gaucho	es
intermezzo	it
XBW	acro
DJ	acro
VIP	acro
DOS	acro
HIV	acro
SMS	acro
STAR	acro
TIR	acro
UNIX	acro
CMYK	acro
SGML	acro
sms	acro
ADP	acro
ANSI	acro
API	acro
APS	acro
ASCII	acro
ATP	acro
AWF	acro
BBK	acro
BC	acro
BDK	acro
BFG	acro
BG	acro
BGK	acro
BH	acro
BHK	acro
BISE	acro
BMW	acro
BP:s1	acro
BPH	acro
DNA	acro
NSA	acro
RNA	acro
RSHA	acro
TWA	acro
BIG	acro
BOŚ	acro
BŚ	acro
ChRL	acro
DHL	acro
EUROPOL	acro
FATAH	acro
GL	acro
GUC	acro
HDL	acro
HTML	acro
IBL	acro
KAI	acro
KAL	acro
KUL	acro
LDL	acro
LOK	acro
MAL	acro
BERD	acro
CAD	acro
NEC	acro
OAPEC	acro
OPEC	acro
SAAB	acro
SIMM	acro
AAP	acro
AFP	acro
AGH	acro
AI:s1	acro
AI:s2	acro
AK	acro
AP:s1	acro
AP:s2	acro
AR	acro
ARiMR	acro
ASP	acro
ATK	acro
AWS	acro
ABS	acro
ADM	acro
ADN	acro
AF	acro
AIDS	acro
AIF	acro
AL	acro
AM	acro
AMERBANK	acro
AON	acro
ASEAN	acro
ASR	acro
AZS	acro
BAAS	acro
BASF	acro
ANSA	acro
CEFTA	acro
CIA	acro
DPA	acro
EFTA	acro
ELTA	acro
ENEA	acro
EPA	acro
ETA	acro
INA	acro
IRA	acro
JANA	acro
KNA	acro
NAFTA	acro
NASA	acro
NRA	acro
OPA	acro
PA	acro
PIA	acro
RPA	acro
ABB	acro
ABC	acro
AC	acro
ATT	acro
BBC	acro
BCG	acro
AGD	acro
LP:s1	acro
LZS	acro
MTP	acro
MŚ:s2	acro
OHP	acro
PKP	acro
UN	acro
WSiP	acro
WZiZT	acro
USA	acro
ZEA	acro
CIT	acro
DAT	acro
FAT	acro
LOT	acro
NOT	acro
OIT	acro
PAGART	acro
PIT	acro
VAT	acro
WAT	acro
ZHR	acro
tv	acro
PIT:s1	acro
ABBA	acro
APA	acro
FAMA	acro
LETTA	acro
MENA	acro
SABENA	acro
UEFA	acro
MKOl	acro
MOK	acro
MPiK	acro
MŚ:s1	acro
NASK	acro
NHL	acro
NIK	acro
NKOl	acro
PAH	acro
PAL	acro
PESEL	acro
PIH	acro
PKOl	acro
PLL	acro
PŁ	acro
URL	acro
UŚ	acro
UŚl	acro
WIG	acro
BBWR	acro
BGŻ	acro
BIOS	acro
BN	acro
BOR	acro
BPS	acro
BR	acro
BRBM	acro
BRR	acro
BS	acro
BSR	acro
BZ	acro
CAF	acro
CAM	acro
CD-ROM	acro
COCOM	acro
CRZZ	acro
CWKS	acro
DAB	acro
DLS	acro
ICJ	acro
IPN	acro
ISBN	acro
ISDN	acro
ISSN	acro
KERM	acro
MSZ	acro
NIP	acro
ONZ	acro
PKS	acro
PSS	acro
RN:s1	acro
SARS	acro
UJ	acro
UOP	acro
VHF	acro
VHS	acro
WAP	acro
WiP	acro
DM	acro
DS	acro
DVD-ROM	acro
EBOR	acro
EBOiR	acro
EPROM	acro
ERM	acro
ESOP	acro
FADOM	acro
FAS	acro
FOZZ	acro
FPŻ	acro
FSM	acro
GKS	acro
GM	acro
GOPR	acro
GPRS	acro
GPS	acro
GS	acro
GUS	acro
IFOR	acro
IMiD	acro
KBN	acro
KLM	acro
KM:s1	acro
KOR	acro
KPN	acro
KSERM	acro
LAN	acro
MBOiR	acro
MDM	acro
MEN	acro
MF	acro
MGM:s1	acro
MKS	acro
MKiDN	acro
MON	acro
MOSiR	acro
MS-DOS	acro
MTS	acro
NEP	acro
NSZ	acro
OBOP	acro
OCR	acro
ONR	acro
ORWN	acro
OZN	acro
PANAM	acro
PBKS	acro
PBR	acro
PFRON	acro
PGR	acro
PIN	acro
PIP:s1	acro
PIW	acro
PKWN	acro
PKiN	acro
PPS	acro
PR:s1	acro
PRON	acro
PRS	acro
PUR	acro
PWN	acro
PZPN	acro
PŻM	acro
RAF	acro
RAM	acro
REGON	acro
RFN	acro
ROM	acro
ROP	acro
ROR	acro
RPN	acro
RUM	acro
RUP	acro
RdR	acro
SAS	acro
SCMS	acro
SECAM	acro
SIM	acro
SKS	acro
SPF	acro
SPN	acro
SUDANAIR	acro
TPN	acro
TS	acro
UAM	acro
UKF	acro
UM	acro
UMCS	acro
UMTS	acro
UNICEF	acro
UNZ	acro
UPS	acro
URM	acro
URz	acro
US	acro
UWM	acro
UWr	acro
UZ	acro
VCR	acro
WAN	acro
WBZ	acro
ZZ	acro
ckm	acro
lkm	acro
scs	acro
wf	acro
ŁBR	acro
ŁKS	acro
ŚPN	acro
WEP	acro
WF	acro
WKR	acro
WOP	acro
WOPR	acro
WSM	acro
WiN	acro
ZAIKS	acro
ZASP	acro
ZBOWiD	acro
ZBoWiD	acro
ZMS	acro
ZOM	acro
ZOSP	acro
ZOZ	acro
ZS	acro
ZUS	acro
ZWM	acro
ZWZ	acro
BWZ	acro
HDZ	acro
MWGzZ	acro
MZ	acro
OPZZ	acro
ZSZ	acro
MB	acro
TAB	acro
ŻOB	acro
NRF	acro
PKF	acro
RMF	acro
SPATiF	acro
TKKF	acro
IBM	acro
KM:s2	acro
MGM:s2	acro
PAM	acro
PGM	acro
RM	acro
SM:s2	acro
ŚAM	acro
CNN	acro
CPN	acro
FN	acro
KEN	acro
KRN	acro
LN	acro
MN	acro
PAN	acro
PN	acro
REN	acro
RN:s2	acro
WRN:s1	acro
WRON	acro
ZChN	acro
KEP	acro
KSAP	acro
LOP	acro
MEP	acro
MOP	acro
NAP	acro
PAP	acro
PIP:s2	acro
WOŚP	acro
BOS	acro
CBOS	acro
CBS	acro
ITAR-TASS	acro
KRS	acro
KRUS	acro
MPiPS	acro
MS	acro
NZS	acro
PBS	acro
PDS	acro
PS	acro
PiS	acro
RAS	acro
SGPiS	acro
BAV	acro
BUW	acro
TOZ	acro
BJ	acro
PTJ	acro
TKJ	acro
PAI	acro
RAI	acro
SKOK	acro
SOK	acro
PPL	acro
PRL	acro
PSL	acro
SDKPiL	acro
ZSL	acro
PŚ	acro
KPZR	acro
LPR	acro
MRR	acro
PPR	acro
PZPR	acro
TOPR	acro
TPPR	acro
TUR	acro
UPR	acro
GATT	acro
KRRiT	acro
PAT	acro
PIT:s2	acro
FIFA	acro
S.A.	acro
AA:s2	acro
BA	acro
BSA	acro
MSWiA	acro
NBA	acro
NWZA	acro
RCA	acro
SAA	acro
SA	acro
UPA	acro
WZA	acro
YMCA	acro
YWCA	acro
KGB	acro
OB	acro
PB	acro
PKB	acro
PNB	acro
SB	acro
UB	acro
USB	acro
UwB	acro
CFC	acro
C	acro
FC	acro
GMC	acro
KC	acro
LC	acro
NBC	acro
OC	acro
PC	acro
PVC	acro
UC	acro
USC	acro
WC	acro
WTC	acro
FDD	acro
HDD	acro
KLD	acro
KRLD	acro
LCD	acro
LSD	acro
ND	acro
NKWD	acro
NPD	acro
NRD	acro
OECD	acro
OPD	acro
PKD	acro
SChD	acro
SD	acro
SLD	acro
SPD:s1	acro
SPD:s2	acro
TPD	acro
WKD	acro
BRE	acro
BSE	acro
BWE	acro
CINTE	acro
IDE	acro
KBWE	acro
LE	acro
OFE	acro
PHARE	acro
PTE	acro
PZE	acro
RE	acro
RWE	acro
UE	acro
dBASE	acro
SF	acro
DBG	acro
EEG	acro
EKG	acro
EMG	acro
EWG	acro
KG	acro
MG	acro
PBG	acro
PGNiG	acro
PG	acro
PZG	acro
RWPG	acro
SG	acro
UG	acro
USG	acro
LH	acro
OSH	acro
PBH	acro
PH	acro
PZH	acro
SGH	acro
ZGH	acro
pH	acro
FBI	acro
ITI	acro
NFI	acro
SI	acro
TPI	acro
UPI	acro
WSI	acro
BSK	acro
MPK	acro
MZK	acro
PBK	acro
PCK	acro
PK	acro
PTTK	acro
SDK	acro
UMK	acro
WBK	acro
WSK	acro
ZK	acro
MPO	acro
NATO	acro
ORMO	acro
PKO	acro
PLO	acro
PO	acro
PeKaO	acro
RGO	acro
ROPCiO	acro
SEATO	acro
SLO	acro
SO	acro
UFO	acro
UNESCO	acro
UNO	acro
UO	acro
WHO	acro
WMO	acro
WTO	acro
ZOMO	acro
IQ	acro
Q	acro
PPP	acro
SDP	acro
SMJP	acro
SPP:s1	acro
SP	acro
SdRP	acro
TP:s1	acro
TP:s2	acro
TWP	acro
TZSP	acro
UP	acro
WNP	acro
WP	acro
WSP	acro
ZHP	acro
ZLP	acro
ZMP	acro
ZNP	acro
ZSMP	acro
ZSP	acro
PCR	acro
PR:s2	acro
SGGW-AR	acro
ZSRR	acro
ZSSR	acro
CGS	acro
IS	acro
SOS	acro
SS:s1	acro
DDT	acro
MT	acro
TNT	acro
UHT	acro
UPT	acro
CDU	acro
CKU	acro
CPU	acro
CSU	acro
EBU	acro
ECU	acro
GPU	acro
PAU	acro
PZU	acro
WKU	acro
CV	acro
PCV	acro
PRiTV	acro
TGV	acro
KW:s3	acro
MFW	acro
MPW	acro
MRiRW	acro
MSW	acro
NW	acro
PCW	acro
POW	acro
PW	acro
RSW	acro
SGGW	acro
TW	acro
UKSW	acro
UW:s1	acro
UW:s2	acro
VW	acro
WFSW	acro
WSW	acro
ŻW:s1	acro
ŻZW	acro
LZ	acro
UŁ	acro
CPLiA	acro
SAPA	acro
UNRRA	acro
VGA	acro
ChD	acro
FIDE	acro
KE	acro
FK	acro
PTK	acro
SM:s1	acro
TVN	acro
FAO	acro
FSO	acro
ISO	acro
KKO:s2	acro
KRO	acro
MO	acro
BP:s5	acro
BSP:s2	acro
DOKP	acro
FDP:s1	acro
KPP	acro
KWP	acro
NSDAP	acro
OSP	acro
OWP:s2	acro
PKZP	acro
PPPP	acro
RP	acro
TVP	acro
SS:s2	acro
WFTU	acro
CTV	acro
MTV	acro
TV	acro
KW:s1	acro
MW	acro
WWW	acro
ŻW:s2	acro
NZ	acro
W-Z	acro
HB	acro
ZPB	acro
CD	acro
PKLD	acro
GBH	acro
EBI	acro
PCI	acro
CK	acro
GBGK	acro
MCK	acro
MDK	acro
TK	acro
JAL	acro
NCL	acro
QAL	acro
GSM	acro
KGHM	acro
REM	acro
ON	acro
PEN	acro
PKN	acro
WRN:s2	acro
GIODO	acro
KKO:s1	acro
RPO	acro
BSP:s1	acro
CKŻP	acro
DBP	acro
EP	acro
HP	acro
HSP	acro
HTTP	acro
IP	acro
KP:s1	acro
KP:s2	acro
MP:s1	acro
NBP	acro
ORP	acro
OWP:s1	acro
SPP:s2	acro
UTP	acro
LR	acro
NMT	acro
PDT	acro
RPU	acro
DTV	acro
UV	acro
BW	acro
GBW	acro
KBW:s3	acro
SW	acro
UKW	acro
NSZZ	acro
CZD	acro
DVD	acro
CO	acro
HBO	acro
LO	acro
DTP	acro
FDP:s2	acro
FTP	acro
LP:s3	acro
MP:s2	acro
MSP	acro
BGW	acro
KBW:s1	acro
BHP	acro
CZMP	acro
AA:s1	acro
BCh	acro
