+anka	nazwisko
+ina	nazwisko
+owa	nazwisko
+yna	nazwisko
+ówna	nazwisko
Aaron	imię
Abaddon	imię
Abakanowicz	nazwisko
Abaris	imię
Abdiasz	imię
Abdon	imię
Abel	imię
Abercjusz	imię
Abiasz	imię
Abiatar	imię
Abigail	imię
Abijjam	imię
Abimelek	imię
Abiram	imię
Abisag	imię
Abiszaj	imię
Abner	imię
Abraham	imię
Abram	imię
Abramowicz	nazwisko
Abramowska	nazwisko
Abramowski	nazwisko
Abraxas	imię
Absalom	imię
Absalon	imię
Achab	imię
Achacjusz	imię
Achacy	imię
Achates	imię
Achaz	imię
Achiasz	imię
Achil	imię
Achilles	imię
Achimaas	imię
Achimelech	imię
Achimelek	imię
Achitofel	imię
Achmad	imię
Achmatowa	nazwisko
Acis	imię
Ada	imię
Adad	imię
Adalberg	nazwisko
Adalbert	imię
Adam	imię
Adamastor	imię
Adamczak	nazwisko
Adamczewska	nazwisko
Adamczewski	nazwisko
Adamczyk	nazwisko
Adamek	nazwisko|geograficzna
Adamiak	nazwisko
Adamiec	nazwisko
Adamina	imię
Adamowicz	nazwisko
Adamska	nazwisko
Adamski	nazwisko
Adamus	nazwisko
Adasieczek	imię
Adasiek	imię
Adaukt	imię
Adaś	imię
Addar	imię
Adela	imię
Adelaida	imię
Adelajda	imię
Adelbert	imię
Adelina	imię
Adelka	imię
Adenauer	nazwisko
Adjani	nazwisko
Admet	imię
Ado	imię
Adolf	imię
Adolfa	imię
Adolfek	imię
Adolfina	imię
Adonai	imię
Adonaj	imię
Adoniasz	imię
Adonis	imię
Adramelek	imię
Adrast	imię
Adria	imię
Adrian	imię
Adriana	imię
Adrianna	imię
Adwentowicz	nazwisko
Aecjusz	imię
Afanasjew	nazwisko
Afanazy	imię
Afrodyta	imię
Aftoniusz	imię
Aga	imię
Agamemnon	imię
Agapia	imię
Agapit	imię
Agata	imię
Agatka	imię
Agaton	imię
Agatonik	imię
Agca	nazwisko
Agenor	imię
Ageusz	imię
Aggeasz	imię
Aggeusz	imię
Agha	imię
Agis	imię
Agni	imię
Agnieszka	imię
Agramant	imię
Agrykola	nazwisko|geograficzna
Agrypin	imię
Agrypina	imię
Agryppa	imię
Agunia	imię
Agusia	imię
Ahaswer	imię
Ahmed	imię
Aida	imię
Ajdukiewicz	nazwisko
Ajschylos	imię
Akacjusz	imię
Aksentowicz	nazwisko
Akwilon	imię
Al	imię
Ala	imię
Aladyn	imię
Aladár	imię
Alan	imię
Alaryk	imię
Alban	imię
Albaniusz	imię
Albeniz	nazwisko
Albercik	imię
Albert	imię
Alberta	imię
Alberto	imię
Albertrandi	nazwisko
Albertus	imię
Albertyn	imię
Albertyna	imię
Albin	imię
Albina	imię
Albrecht	imię
Albright	nazwisko
Alcybiades	imię
Aldona	imię
Aldonka	imię
Alek	imię
Aleks	imię
Aleksander	imię
Aleksandra	imię
Aleksandrowicz	nazwisko
Aleksiej	imię
Aleksy	imię
Alembert	nazwisko
Alf	imię
Alfons	imię
Alfonsyna	imię
Alfred	imię
Alfreda	imię
Alfredo	imię
Ali	imię
Alicja	imię
Alighieri	nazwisko
Alina	imię
Alinka	imię
Alka	imię
Alkmena	imię
Alkmeon	imię
Allach	imię
Allah	imię
Allan	imię
Allen	nazwisko
Allende	nazwisko
Almanzor	imię
Alo	imię
Alojza	imię
Alojzeczek	imię
Alojzek	imię
Alojzik	imię
Alojzy	imię
Alosza	imię
Alpinian	imię
Alusia	imię
Aluś	imię
Alzheimer	nazwisko
Amadea	imię
Amadeusz	imię
Amalia	imię
Amalryk	imię
Amaltea	imię
Amalteja	imię
Amanda	imię
Amati	nazwisko
Ambroziak	nazwisko
Ambrozik	imię
Ambrożek	imię
Ambroży	imię
Amedeusz	imię
Amelcia	imię
Amelia	imię
Amelka	imię
Amicis	nazwisko
Ammon	imię
Amnon	imię
Amon	imię
Amor	imię
Amos	imię
Ampére	nazwisko
Amundsen	nazwisko
Anakreont	nazwisko
Anaksagoras	nazwisko
Anaksymander	nazwisko
Anaksymenes	nazwisko
Anan	nazwisko
Ananiasz	imię
Ananke	imię
Anastazja	imię
Anastazy	imię
Anatol	imię
Anatolek	imię
Anatolia	imię|geograficzna
Anda	imię
Anders	nazwisko
Andersen	nazwisko
Andonik	imię
Andreotti	nazwisko
Andriej	imię
Andriolli	nazwisko
Andrić	nazwisko
Andromacha	imię
Andromeda	imię|astr.
Andrycz	nazwisko
Andrzej	imię
Andrzejczak	nazwisko
Andrzejek	imię
Andrzejewska	nazwisko
Andrzejewski	nazwisko
Andrássy	nazwisko
André	imię
Andzia	imię
Aneczka	imię
Aneta	imię
Anetka	imię
Angel	imię
Angela	imię
Angelico	imię
Angelika	imię
Angelina	imię
Angelus	imię
Anhelli	imię
Ania	imię
Anicet	imię
Aniela	imię
Anielcia	imię
Anielka	imię
Anioł	nazwisko
Anita	imię
Anka	imię
Ankwicz	nazwisko
Ankwiczówna	nazwisko
Anna	imię
Annasz	imię
Anouilh	nazwisko
Antczak	nazwisko
Ante	imię
Antek	imię
Antemiusz	imię
Antenor	imię
Antioch	imię
Antkowiak	nazwisko
Antoni	imię
Antonin	imię
Antonina	imię
Antonio	imię
Antonioni	nazwisko
Antoniuk	nazwisko|geograficzna
Antoniusz	imię
Antosia	imię
Antoś	imię
Antygona	imię
Antym	imię
Antypas	imię
Antystenes	nazwisko
Anula	imię
Anusia	imię
Anusiewicz	nazwisko
Anzelm	imię
Apolinariusz	imię
Apolinary	imię
Apollin	imię
Apollinaire	nazwisko
Apollo	imię
Apollon	imię
Apolonia	imię
Apoloniusz	imię
Apresjan	nazwisko
Arachne	imię
Arafat	nazwisko
Aragon	nazwisko
Archimedes	imię
Archip	imię
Arct	nazwisko
Arctowa	nazwisko
Arek	imię
Arendarska	nazwisko
Arendarski	nazwisko
Arendt	nazwisko
Ares	imię
Argos	imię|geograficzna
Argus	imię
Ariadna	imię
Ariosto	nazwisko
Aristide	nazwisko|imię
Arkadiusz	imię
Arkady	imię
Arkuszewska	nazwisko
Arkuszewski	nazwisko
Arletta	imię
Armand	imię
Armstrong	nazwisko
Arnold	imię
Arnolf	imię
Arnosz	imię
Aron	imię
Arrow	nazwisko
Arseniusz	imię
Artek	imię
Artemida	imię
Artemiusz	imię
Artemon	imię
Artur	imię
Artus	imię
Artuś	imię
Arystarch	imię
Arystofanes	imię
Arystoteles	imię
Arystydes	imię
Asia	imię
Askaniusz	imię
Asmodeusz	imię
Asnyk	nazwisko
Asser	imię
Astaire	nazwisko
Asteria	imię
Asteriusz	imię
Asterix	imię
Atanazja	imię
Atanazy	imię
Atena	imię
Atka	imię
Atlas	imię|geograficzna
Attenborough	nazwisko
Auden	nazwisko
Auderska	nazwisko
Auderski	nazwisko
Augiasz	imię
August	imię
Augusta	imię
Augustyn	imię
Augustyna	imię
Augustyniak	nazwisko
Augustynka	imię
Aujeszky	nazwisko
Auksencjusz	imię
Aureli	imię
Aurelia	imię
Aurelian	imię
Aureliusz	imię
Aurora	imię
Austen	nazwisko
Austin	nazwisko
Avogadro	nazwisko
Awdiejew	nazwisko
Awicenna	nazwisko
Aza	imię
Azazel	imię
Aznavour	nazwisko
Azor	imię
Aśka	imię
Ażi	imię
Baal	imię
Bacciarelli	nazwisko
Bacewiczówna	nazwisko
Bach	nazwisko
Bachleda	nazwisko
Bachtin	nazwisko
Bachus	imię
Bacon	nazwisko
Baczewska	nazwisko
Baczewski	nazwisko
Baczyńska	nazwisko
Baczyński	nazwisko
Baden	nazwisko
Badeni	nazwisko
Badowska	nazwisko
Badowski	nazwisko
Baedeker	nazwisko
Bagińska	nazwisko
Bagiński	nazwisko
Baird	nazwisko
Bajerowa	nazwisko
Bajon	nazwisko
Bakchus	imię
Baker	nazwisko|geograficzna
Balazs	nazwisko
Balbin	imię
Balbina	imię
Balcer	imię
Balcerowicz	nazwisko
Balcerzak	nazwisko
Balicka	nazwisko
Balicki	nazwisko
Balińska	nazwisko
Baliński	nazwisko
Balladyna	imię
Baltazar	imię
Balzac	nazwisko
Balzak	nazwisko
Bambo	imię
Banach	nazwisko
Banachiewicz	nazwisko
Banasiak	nazwisko
Banaszak	nazwisko
Banaś	nazwisko
Banderas	nazwisko
Bandrowska	nazwisko
Bandrowski	nazwisko
Bandtkie	nazwisko
Bandurska	nazwisko
Bandurski	nazwisko
Bania	nazwisko
Baptysta	imię
Barabasz	imię
Baran	nazwisko|astr.
Baranowska	nazwisko
Baranowski	nazwisko
Barańczak	nazwisko
Barańska	nazwisko
Barański	nazwisko
Barbar	imię
Barbara	imię
Barbarka	imię
Barbórka	imię
Barcikowska	nazwisko
Barcikowski	nazwisko
Bardini	nazwisko
Bardot	nazwisko
Bareja	nazwisko
Barents	nazwisko
Barnaba	imię
Barnaś	nazwisko
Barrault	nazwisko
Barrie	nazwisko
Barrès	nazwisko
Barrés	nazwisko
Barsabas	imię
Barszczewska	nazwisko
Barszczewski	nazwisko
Bartczak	nazwisko
Bartek	imię
Barthes	nazwisko
Bartkowiak	nazwisko
Bartodziej	nazwisko|imię
Bartok	nazwisko
Bartolomea	imię
Bartosz	imię
Bartoszcze	nazwisko
Bartoszek	imię
Bartoszewska	nazwisko
Bartoszewski	nazwisko
Bartuś	imię
Bartók	nazwisko
Bartłomiej	imię
Baruch	nazwisko|imię
Barysznikow	nazwisko
Basedow	nazwisko
Basia	imię
Basińska	nazwisko
Basiński	nazwisko
Bastek	imię
Bata	nazwisko
Batory	nazwisko
Batszeba	imię
Baudelaire	nazwisko
Baudouin	nazwisko
Baumgart	nazwisko
Bazyl	imię
Bazyli	imię
Bazylid	imię
Bazylis	imię
Bazylisa	imię
Bazylissa	imię
Bazyliusz	imię
Bałucka	nazwisko
Bałucki	nazwisko
Bańkowska	nazwisko
Bańkowski	nazwisko
Baśka	imię
Bean	imię
Beata	imię
Beatka	imię
Beatrice	imię
Beatrycze	imię
Beatryks	imię
Beatus	imię
Beaufort	nazwisko
Beaumarchais	nazwisko
Beauvoir	nazwisko
Beck	nazwisko
Beckett	nazwisko
Becu	nazwisko
Beda	imię
Bednarczyk	nazwisko
Bednarek	nazwisko
Bednarska	nazwisko
Bednarski	nazwisko
Bednarz	nazwisko
Bedyńska	nazwisko
Bedyński	nazwisko
Beecher	nazwisko
Beethoven	nazwisko
Begina	imię
Behem	nazwisko
Bejart	nazwisko
Bela	imię
Belina	nazwisko
Belka	nazwisko
Bell	nazwisko
Bellini	nazwisko
Bellonte	nazwisko
Bellotto	nazwisko
Bellow	nazwisko
Belmondo	nazwisko
Belunia	imię
Belzebub	imię
Bem	nazwisko
Ben	imię
Bender	nazwisko
Benedykt	imię
Benedykta	imię
Benek	imię
Benesz	nazwisko
Beniamin	imię
Benicjusz	imię
Benigna	imię
Benignus	imię
Benio	imię
Beniowska	nazwisko
Beniowski	nazwisko
Benita	imię
Benoit	nazwisko
Benon	imię
Bensyjon	imię
Benuś	imię
Benveniste	nazwisko
Ber	imię
Bercik	imię
Berecci	nazwisko
Berek	imię
Berenika	imię
Berenike	imię
Berent	nazwisko
Bereza	nazwisko|geograficzna
Berezowska	nazwisko
Berezowski	nazwisko
Bereś	nazwisko
Bergman	nazwisko
Bergson	nazwisko
Beria	nazwisko
Bering	nazwisko
Berkeley	nazwisko|geograficzna
Berlioz	nazwisko
Berlusconi	nazwisko
Berman	imię
Bernadeta	imię
Bernadetta	imię
Bernadotte	nazwisko
Bernard	imię
Bernardetta	imię
Bernardyn	imię
Bernardyna	imię
Bernini	nazwisko
Bert	imię
Berta	imię
Bertold	imię
Bertolucci	nazwisko
Bertram	imię
Bertrand	imię
Bestużew	nazwisko
Betina	nazwisko
Bianka	imię
Białecka	nazwisko
Białecki	nazwisko
Białek	nazwisko
Białko	nazwisko
Białkowska	nazwisko
Białkowski	nazwisko
Białoszewska	nazwisko
Białoszewski	nazwisko
Biały	nazwisko
Bibiana	imię
Bibianna	imię
Biegańska	nazwisko
Biegański	nazwisko
Biel	nazwisko
Bielecka	nazwisko
Bielecki	nazwisko
Bielińska	nazwisko
Bieliński	nazwisko
Bieniek	nazwisko
Biernacka	nazwisko
Biernacki	nazwisko
Biernat	nazwisko|imię
Bierut	nazwisko
Bień	nazwisko
Bieńkowska	nazwisko
Bieńkowski	nazwisko
Bil	imię
Bilińska	nazwisko
Biliński	nazwisko
Bill	imię
Bilska	nazwisko
Bilski	nazwisko
Biskupska	nazwisko
Biskupski	nazwisko
Bismarck	nazwisko
Bittnerówna	nazwisko
Bińkowska	nazwisko
Bińkowski	nazwisko
Blair	nazwisko
Blake	nazwisko
Blanchard	nazwisko
Blandyn	imię
Blandyna	imię
Blanka	imię
Bleriot	nazwisko
Blikle	nazwisko
Blixen	nazwisko
Blizbor	imię
Bob	imię
Bober	nazwisko
Bobińska	nazwisko
Bobiński	nazwisko
Bobrowska	nazwisko
Bobrowski	nazwisko
Bobrzyński	nazwisko
Boccaccio	nazwisko
Boccherini	nazwisko
Bochenko	nazwisko
Bocheńska	nazwisko
Bocheński	nazwisko
Bochniarz	nazwisko
Boczkowska	nazwisko
Boczkowski	nazwisko
Boecklin	nazwisko
Bogda	imię
Bogdan	imię
Bogdana	imię
Bogdanek	imię
Bogdanka	imię
Bogdanowicz	nazwisko
Bogdańska	nazwisko
Bogdański	nazwisko
Bogna	imię
Bogoryja	nazwisko
Boguchwał	imię
Boguchwała	imię
Bogucka	nazwisko
Bogucki	nazwisko
Bogudar	imię
Bogumir	imię
Bogumił	imię
Bogumiła	imię
Bogunia	imię
Bogurad	imię
Bogusia	imię
Bogusz	nazwisko|imię
Boguszewska	nazwisko
Boguszewski	nazwisko
Bogusąd	imię
Bogusław	imię
Bogusława	imię
Bogusławska	nazwisko
Bogusławski	nazwisko
Boguta	imię
Boguwola	imię
Boguś	imię
Boguśka	imię
Bohatyrowicz	nazwisko
Bohdan	imię
Bohdana	imię
Bohdanek	imię
Bohdziewicz	nazwisko
Bohomolec	nazwisko
Bohusz	nazwisko|imię
Boileau	nazwisko
Bojan	imię
Bolebor	imię
Boleczek	imię
Boleczest	imię
Bolek	imię
Bolemir	imię
Bolemysł	imię
Bolesław	imię|geograficzna
Bolesława	imię
Boleyn	nazwisko
Bolisława	imię
Bolivar	nazwisko
Bolko	imię
Boluś	imię
Bonaparte	nazwisko
Bonawentura	imię
Boni	nazwisko
Boniecki	nazwisko
Boniek	nazwisko
Bonifacy	imię
Boratyńska	nazwisko
Boratyński	nazwisko
Boreczek	nazwisko|geograficzna
Borejko	nazwisko
Borejsza	nazwisko
Borek	nazwisko|geograficzna
Borgia	nazwisko
Borkowska	nazwisko
Borkowski	nazwisko
Bormann	nazwisko
Borodin	nazwisko
Boromeusz	imię
Borowska	nazwisko
Borowski	nazwisko
Borusewicz	nazwisko
Boruta	nazwisko
Borys	imię
Borysiak	nazwisko
Borysław	imię|geograficzna
Borzym	nazwisko|geograficzna
Borzymir	imię
Borzysław	imię
Borzysława	imię
Borzywoj	imię
Bosak	nazwisko
Botha	nazwisko
Bourdelle	nazwisko
Bovary	nazwisko
Boyle	nazwisko
Bozio	imię
Boznański	nazwisko
Bończa	imię
Bożebor	imię
Bożeciech	imię
Bożeciecha	imię
Bożena	imię
Bożenka	imię
Bożenna	imię
Bożydar	imię
Bożysław	imię
Bożysława	imię
Bradbury	nazwisko
Brahma	imię
Brahms	nazwisko
Braille	nazwisko
Bramah	nazwisko
Bramante	nazwisko
Brandauer	nazwisko
Brando	nazwisko
Brandstaetter	nazwisko
Brandt	nazwisko
Brandys	nazwisko
Branicka	nazwisko
Branicki	nazwisko
Braniecka	nazwisko
Braniecki	nazwisko
Brantôme	nazwisko
Braque	nazwisko
Bratkowska	nazwisko
Bratkowski	nazwisko
Bratumił	imię
Braun	nazwisko
Brazauskas	nazwisko
Brecht	nazwisko
Bregović	nazwisko
Brel	nazwisko
Breughel	nazwisko
Breza	nazwisko
Breżniew	nazwisko
Brian	imię
Briand	nazwisko
Brigida	imię
Britten	nazwisko
Brodowska	nazwisko
Brodowski	nazwisko
Brodska	nazwisko
Brodski	nazwisko
Brodzisław	imię
Brodzińska	nazwisko
Brodziński	nazwisko
Brodzka	nazwisko
Brodzki	nazwisko
Broneczek	imię
Bronek	imię
Bronia	imię
Broniewska	nazwisko
Broniewski	nazwisko
Bronimir	imię
Bronisz	imię
Bronisław	imię
Bronisława	imię
Broniwoj	imię
Bronka	imię
Brontë	nazwisko
Bronuś	imię
Brooke	nazwisko
Brown	nazwisko
Browning	nazwisko
Brońcia	imię
Broży	imię
Bruce	nazwisko
Bruegel	nazwisko
Brun	nazwisko
Brunelleschi	nazwisko
Brunhilda	imię
Bruno	imię
Brunon	imię
Brutus	imię
Bryda	imię
Brygida	imię
Brygidka	imię
Brykcjusz	imię
Bryll	nazwisko
Brzezińska	nazwisko
Brzeziński	nazwisko
Brzostek	nazwisko|geograficzna
Brzoza	nazwisko|geograficzna
Brzozowicz	nazwisko
Brzozowska	nazwisko
Brzozowski	nazwisko
Brâncuşi	nazwisko
Brâtianu	nazwisko
Brückner	nazwisko
Bucharin	nazwisko
Buczek	nazwisko
Buczkowska	nazwisko
Buczkowski	nazwisko
Buczyńska	nazwisko
Buczyński	nazwisko
Budryk	nazwisko
Budzigniew	imię
Budzimir	imię
Budzisz	imię
Budziszewska	nazwisko
Budziszewski	nazwisko
Budzisław	imię
Budzisława	imię
Budziwoj	imię
Budzińska	nazwisko
Budziński	nazwisko
Buffon	nazwisko
Bugaj	nazwisko
Bugajska	nazwisko
Bugajski	nazwisko
Bugalska	nazwisko
Bugalski	nazwisko
Bujnowska	nazwisko
Bujnowski	nazwisko
Bujwid	nazwisko
Bukowiec	nazwisko|geograficzna
Bukowski	nazwisko
Bullock	nazwisko
Bunsch	nazwisko
Bunsen	nazwisko
Buonaccorsi	nazwisko
Buonarotti	nazwisko
Buraczyńska	nazwisko
Buraczyński	nazwisko
Burakowska	nazwisko
Burakowski	nazwisko
Burchard	imię
Burne	nazwisko
Burnett	nazwisko
Burns	nazwisko
Bury	nazwisko
Burzyńska	nazwisko
Burzyński	nazwisko
Bush	nazwisko
Butros	imię
Buxtehude	nazwisko
Buyno	nazwisko
Buzek	nazwisko
Buñuel	nazwisko
Bułhakow	nazwisko
Buźka	nazwisko
Bykau	nazwisko
Byron	nazwisko
Bystroń	nazwisko
Bór	nazwisko
Bączkowska	nazwisko
Bączkowski	nazwisko
Bądzimir	imię
Bądzisław	imię
Bądzisława	imię
Bąk	nazwisko
Bęben	nazwisko
Błaszczak	nazwisko
Błaszczyk	nazwisko
Błażej	imię
Błażejewska	nazwisko
Błażejewski	nazwisko
Błok	nazwisko
Błońska	nazwisko
Błoński	nazwisko
Cackowska	nazwisko
Cackowski	nazwisko
Cagliostro	nazwisko
Caillois	nazwisko
Calderon	nazwisko
Caldwell	nazwisko
Caligula	imię
Calineczka	imię
Callas	nazwisko
Campanella	nazwisko
Campbell	nazwisko
Camus	nazwisko
Canaletto	nazwisko
Canova	nazwisko
Capone	nazwisko
Capote	nazwisko
Caprio	nazwisko
Caprivi	nazwisko|geograficzna
Caravaggio	nazwisko
Cardin	nazwisko
Cardinale	nazwisko
Carl	imię
Carlo	imię|geograficzna
Carlos	imię
Carmen	imię
Carnap	nazwisko
Carnegie	nazwisko
Carra	nazwisko
Carracci	nazwisko
Carreras	nazwisko
Carrol	nazwisko
Carter	nazwisko
Caruso	nazwisko
Casanova	nazwisko
Casaroli	nazwisko
Castro	nazwisko
Cazin	nazwisko
Ceauşescu	nazwisko
Cechna	imię
Cecyl	imię
Cecylia	imię
Cecylian	imię
Cecyliusz	imię
Cecylka	imię
Cegielska	nazwisko
Cegielski	nazwisko
Cela	imię
Celestyn	imię
Celestyna	imię
Celestynka	imię
Celina	imię
Celinka	imię
Celińska	nazwisko
Celiński	nazwisko
Celka	imię
Cellini	nazwisko
Celsjusz	nazwisko
Celtes	nazwisko
Cendrowska	nazwisko
Cendrowski	nazwisko
Centkiewicz	nazwisko
Centkowska	nazwisko
Centkowski	nazwisko
Cerha	nazwisko
Cervantes	nazwisko
Cezanne	nazwisko
Cezar	imię
Cezariusz	imię
Cezary	imię
Cezaryna	imię
Chabrol	nazwisko
Chaczaturian	nazwisko
Chagall	nazwisko
Chaim	imię
Chaja	imię
Cham	imię
Chamberlain	nazwisko
Chandler	nazwisko
Chanel	nazwisko
Chaplin	nazwisko
Chardin	nazwisko
Charles	pseudonim|imię
Charon	imię
Charybda	imię
Charytka	imię
Charyton	imię
Charyzjusz	imię
Charłamp	imię
Chasbułatow	nazwisko
Chasyda	imię
Chateaubriand	nazwisko
Chaucer	nazwisko
Chawa	imię
Chałubiński	nazwisko
Cheops	imię
Cher	imię|geograficzna
Chevalier	nazwisko
Chełmońska	nazwisko
Chełmoński	nazwisko
Chirac	nazwisko
Chirico	nazwisko
Chmiel	nazwisko
Chmielewska	nazwisko
Chmielewski	nazwisko
Chmielnicka	nazwisko
Chmielnicki	nazwisko
Chmielowska	nazwisko
Chmielowski	nazwisko
Chociebor	imię
Chociemir	imię
Chociesław	imię
Chodkiewicz	nazwisko
Chodowiecki	nazwisko
Chodźko	nazwisko
Choińska	nazwisko
Choiński	nazwisko
Chojecka	nazwisko
Chojecki	nazwisko
Chojnacka	nazwisko
Chojnacki	nazwisko
Cholewińska	nazwisko
Cholewiński	nazwisko
Chomeini	nazwisko
Chomsky	nazwisko
Chopin	nazwisko
Choromańska	nazwisko
Choromański	nazwisko
Chreptowicz	nazwisko
Christian	imię
Christie	nazwisko
Christophe	imię
Christopher	imię
Chrobak	nazwisko
Chronos	imię
Chrostowska	nazwisko
Chrostowski	nazwisko
Chruszczow	nazwisko
Chruściel	nazwisko|geograficzna
Chrysler	nazwisko
Chrystian	imię
Chryzant	imię
Chryzostom	imię
Chrzanowska	nazwisko
Chrzanowski	nazwisko
Chudy	nazwisko
Chudzyńska	nazwisko
Chudzyński	nazwisko
Churchill	nazwisko
Churriguera	nazwisko
Chwalibóg	imię
Chwalimir	imię
Chwalisław	imię
Chwalisława	imię
Chwin	nazwisko
Chwistek	nazwisko
Chylińska	nazwisko
Chyliński	nazwisko
Chłopicki	nazwisko
Cibor	imię
Ciborowska	nazwisko
Ciborowski	nazwisko
Cichocka	nazwisko
Cichocki	nazwisko
Cichoń	nazwisko
Cichy	nazwisko
Ciechomir	imię
Ciechomska	nazwisko
Ciechomski	nazwisko
Ciechosław	imię
Ciechosława	imię
Ciecierska	nazwisko
Ciecierski	nazwisko
Ciepłowska	nazwisko
Ciepłowski	nazwisko
Cierpisz	nazwisko|geograficzna
Cierpisław	imię
Ciesielski	nazwisko
Cieszygor	imię
Cieszymir	imię
Cieszymysł	imię
Cieszyrad	imię
Cieszysław	imię
Cieszysława	imię
Cieśla	nazwisko
Cieślak	nazwisko
Cieślik	nazwisko
Cieślikowa	nazwisko
Cieślikowska	nazwisko
Cieślikowski	nazwisko
Cieślińska	nazwisko
Cieśliński	nazwisko
Cimoszewicz	nazwisko
Ciszewska	nazwisko
Ciszewski	nazwisko
Clair	nazwisko
Claude	imię
Clemenceau	nazwisko
Clinton	nazwisko
Cocteau	nazwisko
Cohen	nazwisko
Collins	nazwisko
Connery	nazwisko
Conrad	nazwisko
Constable	nazwisko
Cook	nazwisko
Cooper	nazwisko
Coppola	nazwisko
Corazzi	nazwisko
Corbusier	nazwisko
Corneille	nazwisko
Corot	nazwisko
Correggio	nazwisko
Cortazar	nazwisko
Cortez	nazwisko
Costes	nazwisko
Costner	nazwisko
Coulomb	nazwisko
Courbet	nazwisko
Courtenay	nazwisko
Cousteau	nazwisko
Cranach	nazwisko
Craxi	nazwisko
Croce	nazwisko
Cromwell	nazwisko
Cruise	nazwisko
Crusoe	nazwisko
Curie	nazwisko
Curuś	nazwisko
Curwood	nazwisko
Curzon	nazwisko
Cweta	imię
Cwietajewa	nazwisko
Cy-jang	nazwisko
Cybis	nazwisko
Cybulska	nazwisko
Cybulski	nazwisko
Cycero	imię
Cyceron	imię
Cyla	imię
Cylka	imię
Cymborowska	nazwisko
Cymborowski	nazwisko
Cypisek	imię
Cyprian	imię
Cyrankiewicz	nazwisko
Cyrano	imię
Cyrce	imię
Cyriak	imię
Cyriaka	imię
Cyrus	imię
Cyryl	imię
Cywińska	nazwisko
Cywiński	nazwisko
Cyzio	nazwisko
Czachowska	nazwisko
Czachowski	nazwisko
Czacka	nazwisko
Czacki	nazwisko
Czaja	nazwisko
Czajka	nazwisko
Czajkowska	nazwisko
Czajkowski	nazwisko
Czapek	nazwisko
Czaplińska	nazwisko
Czapliński	nazwisko
Czapska	nazwisko
Czapski	nazwisko
Czarek	imię
Czarkowska	nazwisko
Czarkowski	nazwisko
Czarnecka	nazwisko
Czarnecki	nazwisko
Czarniecka	nazwisko
Czarniecki	nazwisko
Czartoryska	nazwisko
Czartoryski	nazwisko
Czaruś	imię
Czcibor	imię
Czcibora	imię
Czcirad	imię
Czech	nazwisko
Czechasz	imię
Czechow	nazwisko
Czechowicz	nazwisko
Czechowska	nazwisko
Czechowski	nazwisko
Czechoń	imię
Czeczott	nazwisko
Czeczło	nazwisko
Czerepowicki	nazwisko
Czerna	nazwisko
Czerniaków	nazwisko|geograficzna
Czerniawska	nazwisko
Czerniawski	nazwisko
Czernomyrdin	nazwisko
Czerny	nazwisko
Czerska	nazwisko
Czerski	nazwisko
Czerwińska	nazwisko
Czerwiński	nazwisko
Czesia	imię
Czesiek	imię
Czesio	imię
Czesław	imię
Czesława	imię
Cześ	imię
Czyż	nazwisko
Czyżamfizben	nazwisko
Czyżewska	nazwisko
Czyżewski	nazwisko
Częstobor	imię
Częstogniew	imię
Częstomir	imię
Częstowoj	imię
Dacjan	imię
Dacjausz	imię
Dacjusz	imię
Dadźbog	imię
Dadźbóg	imię
Daehlie	nazwisko
Dafne	imię
Dagmara	imię
Dagna	imię
Dagobert	imię
Dagon	imię
Daguerre	nazwisko
Daisne	nazwisko
Dajan	nazwisko
Dalebor	imię
Dalegor	imię
Dalemir	imię
Dali	nazwisko
Dalibor	imię
Dalton	nazwisko
Damazy	imię
Damian	imię
Damokles	imię
Dan	imię
Dana	imię
Danaida	imię
Danaos	imię
Danek	imię
Daniec	nazwisko
Daniel	imię
Daniela	imię
Danielek	imię
Danik	imię
Danisz	imię
Danka	imię
Dante	nazwisko
Danton	nazwisko
Danusia	imię
Danuta	imię
Danuś	imię
Danuśka	imię
Daria	imię
Dariusz	imię
Darkin	nazwisko
Darlewski	nazwisko
Darocha	nazwisko
Darwin	nazwisko
Daszyńska	nazwisko
Daszyński	nazwisko
David	imię
Davies	nazwisko
Davis	nazwisko|imię
Dawid	imię
Dawida	imię
Dawidek	imię
Dawidziak	nazwisko
Dean	nazwisko|imię
Debora	imię
Debussy	nazwisko
Dec	nazwisko
Decjusz	nazwisko
Dedal	imię
Dedecius	nazwisko
Dederko	nazwisko
Defoe	nazwisko
Degas	nazwisko
Dejanira	imię
Dejmek	nazwisko
Dejnak	nazwisko
Dejnaka	nazwisko
Delacroix	nazwisko
Delavigne	nazwisko
Delerue	nazwisko
Delfina	imię
Delibes	nazwisko
Delon	nazwisko
Deląg	nazwisko
Demarczyk	nazwisko
Dembińska	nazwisko
Dembiński	nazwisko
Dembopolska	nazwisko
Dembopolski	nazwisko
Demeter	imię
Demetra	imię
Demetria	imię
Demetriusz	imię
Demokryt	imię
Demostenes	imię
Deneuve	nazwisko
Deotyma	imię
Depardieu	nazwisko
Dereszowski	nazwisko
Derrida	nazwisko
Dersław	imię
Desargues	nazwisko
Descartes	nazwisko
Dewajtis	imię
Dezyderia	imię
Dezyderiusz	imię
Dezydery	imię
Diana	imię
Dianna	imię
Dickens	nazwisko
Diderot	nazwisko
Diego	imię
Dieter	imię
Dietmar	imię
Dietrich	nazwisko
Dina	imię
Diodor	imię
Diogenes	imię
Diomedes	imię
Dioniza	imię
Dionizja	imię
Dionizjusz	imię
Dionizos	imię
Dionizy	imię
Disnejowska	nazwisko
Disnejowski	nazwisko
Disney	nazwisko
Dixa	nazwisko
Djabong	nazwisko
Dmitrzyk	nazwisko
Dmochowska	nazwisko
Dmochowski	nazwisko
Dmowska	nazwisko
Dmowski	nazwisko
Dobiegniew	imię|geograficzna
Dobiemiest	imię
Dobiemir	imię
Dobiesław	imię
Dobiesława	imię
Dobisława	imię
Dobosz	nazwisko
Dobrawa	imię
Dobrocha	imię
Dobrochna	imię
Dobrociech	imię
Dobrogost	imię
Dobromir	imię
Dobromira	imię
Dobromił	imię
Dobromiła	imię
Dobromysł	imię
Dobronieg	imię
Dobroniega	imię
Dobrosław	imię
Dobrosława	imię
Dobrowiest	imię
Dobrowit	imię
Dobrowoj	imię
Dobrowolska	nazwisko
Dobrowolski	nazwisko
Dobrowój	imię
Dobrymir	imię
Dobrzyńska	nazwisko
Dobrzyński	nazwisko
Dolabella	nazwisko
Dolek	imię
Dolińska	nazwisko
Doliński	nazwisko
Dolores	imię
Dolphy	nazwisko
Doluś	imię
Domagalska	nazwisko
Domagalski	nazwisko
Domagała	nazwisko
Domamir	imię
Domarad	imię
Domarat	imię
Domarski	nazwisko
Domasik	nazwisko
Domasław	imię
Domasława	imię
Domawit	imię
Domańska	nazwisko
Domański	nazwisko
Domeczek	imię
Domek	imię
Domenka	imię
Domeyko	nazwisko
Domicela	imię
Domicjan	imię
Domicjusz	imię
Dominiak	nazwisko
Dominiczek	imię
Dominiczka	imię
Dominik	imię
Dominika	imię
Dominisia	imię
Domisława	imię
Domka	imię
Domosław	imię
Donald	imię
Donat	imię
Donata	imię
Donatello	imię
Donizetti	nazwisko
Donocik	nazwisko
Doppler	nazwisko
Dora	imię
Dorcia	imię
Dorek	imię
Dorfmeister	nazwisko
Doris	imię
Dorka	imię
Doroszewska	nazwisko
Doroszewski	nazwisko
Doroszeńko	nazwisko
Dorota	imię
Doroteusz	imię
Dorotka	imię
Dorywalski	nazwisko
Dosia	imię
Dostojewska	nazwisko
Dostojewski	nazwisko
Douglas	nazwisko
Doumergue	nazwisko
Dow	imię
Down	nazwisko
Dowżenko	nazwisko
Doyle	nazwisko
Dołęga	nazwisko
Dragan	imię
Drake	nazwisko
Drakula	nazwisko
Drebszok	nazwisko
Drewnowska	nazwisko
Drewnowski	nazwisko
Dreyfus	nazwisko
Drogomir	imię
Drogomił	imię
Drogomysł	imię
Drogosław	imię
Drogosława	imię
Drozd	nazwisko
Drozdowska	nazwisko
Drozdowski	nazwisko
Drucki	nazwisko
Drużbacki	nazwisko
Drzewiecka	nazwisko
Drzewiecki	nazwisko
Drzycimska	nazwisko
Drzycimski	nazwisko
Drzymała	nazwisko
Dubczek	nazwisko
Dubicka	nazwisko
Dubicki	nazwisko
Dubiel	nazwisko
Dubois	nazwisko
Duda	nazwisko
Dudajew	nazwisko
Dudek	nazwisko
Dudziak	nazwisko
Dudzińska	nazwisko
Dudziński	nazwisko
Dulias	nazwisko
Dulska	nazwisko
Dulski	nazwisko
Dulębianka	nazwisko
Dumas	nazwisko
Dunaj	nazwisko|geograficzna
Dunajko	nazwisko
Dunant	nazwisko
Dunaway	nazwisko
Duncan	nazwisko
Dunikowska	nazwisko
Dunikowski	nazwisko
Dunin	nazwisko
Durkheim	nazwisko
Dustin	imię
Duszyńska	nazwisko
Duszyński	nazwisko
Dutkiewicz	nazwisko
Dwernicki	nazwisko
Dworakowska	nazwisko
Dworakowski	nazwisko
Dworzak	nazwisko
Dybowska	nazwisko
Dybowski	nazwisko
Dyck	nazwisko
Dygasiński	nazwisko
Dygat	nazwisko
Dykiel	nazwisko
Dylan	nazwisko
Dylewska	nazwisko
Dylewski	nazwisko
Dymitr	imię
Dymitriusz	imię
Dymitrow	nazwisko
Dymna	nazwisko
Dymowska	nazwisko
Dymowski	nazwisko
Dymsza	nazwisko
Dytrych	imię
Dyzio	imię
Dyzma	imię
Dyź	imię
Dziadkowiec	nazwisko
Dziadoń	nazwisko
Dziatkowiec	nazwisko
Działoszyński	nazwisko
Działyński	nazwisko
Dziedzic	nazwisko
Dziersław	imię
Dziersława	imię
Dzierżykraj	imię
Dzierżymir	imię
Dzierżysław	imię
Dzierżysława	imię
Dzierżyńska	nazwisko
Dzierżyński	nazwisko
Dziewięcka	nazwisko
Dziewięcki	nazwisko
Dziewulska	nazwisko
Dziewulski	nazwisko
Dzieński	nazwisko
Dzikowska	nazwisko
Dzikowski	nazwisko
Dziuba	nazwisko
Dziubińska	nazwisko
Dziubiński	nazwisko
Dziudziek	nazwisko
Dziwisz	nazwisko
Dzięcioł	nazwisko
Dzięgiel	nazwisko
Dzięgielewska	nazwisko
Dzięgielewski	nazwisko
Dzwonkowska	nazwisko
Dzwonkowski	nazwisko
Däniken	nazwisko
Dürer	nazwisko
Dürrenmatt	nazwisko
Dąbkowska	nazwisko
Dąbkowski	nazwisko
Dąborowski	nazwisko
Dąbrowska	nazwisko
Dąbrowski	nazwisko
Dąbrówka	imię|geograficzna
Dębniak	nazwisko|geograficzna
Dębnicki	nazwisko
Dębowska	nazwisko
Dębowski	nazwisko
Dębska	nazwisko
Dębski	nazwisko
Długopolski	nazwisko
Długosz	nazwisko|imię
Długoszowski	nazwisko
Eastwood	nazwisko
Eberhard	imię
Eberharter	nazwisko
Eco	nazwisko
Ed	imię
Edda	imię
Edek	imię
Edelman	nazwisko
Edgar	imię
Edi	imię
Edilson	nazwisko
Edison	nazwisko
Edith	imię
Edka	imię
Edmund	imię
Edmunda	imię
Eduś	imię
Edward	imię
Edwarda	imię
Edwin	imię
Edyp	imię
Edyta	imię
Edytka	imię
Edzia	imię
Edzik	imię
Edzio	imię
Efialtes	imię
Efraim	imię
Efrata	imię
Efrem	imię
Egbert	imię
Egeria	imię
Egeusz	imię
Egidiusz	imię
Egon	imię
Eichlerówna	nazwisko
Eichmann	nazwisko
Eiffel	nazwisko
Eile	nazwisko
Einstein	nazwisko
Eisenhower	nazwisko
Eisenstein	nazwisko
Ekiert	nazwisko
Ela	imię
Eleazar	imię
Elek	imię
Elena	imię
Eleonora	imię
Eleonorcia	imię
Eleonorka	imię
Eliade	nazwisko
Eliasz	imię
Eliezer	imię
Eligia	imię
Eligiusz	imię
Elimelech	imię
Elina	imię
Eliot	nazwisko
Eliza	imię
Elizeusz	imię
Eljakim	imię
Elka	imię
Elkana	imię
Ella	imię
Elsner	nazwisko
Elstera	imię
Eluard	nazwisko
Elunia	imię
Eluś	imię
Elvis	imię
Elwira	imię
Elżbieta	imię
Elżbietka	imię
Elżunia	imię
Emanuel	imię
Emerencja	imię
Emerson	nazwisko
Emeryk	imię
Emil	imię
Emilcia	imię
Emilek	imię
Emilia	imię
Emilian	imię
Emiliana	imię
Emiliusz	imię
Emilka	imię
Emma	imię
En-laj	nazwisko
Eneasz	imię
Engel	nazwisko
Engelbert	imię
Engels	nazwisko
Englert	nazwisko
Enoch	imię
Enosz	imię
Eol	imię
Epifan	imię
Epifani	imię
Epifania	imię
Epifaniusz	imię
Epikur	imię
Epistemia	imię
Erast	imię
Erazm	imię
Erazma	imię
Ereb	imię
Erhard	imię
Erich	imię
Erik	imię
Erika	imię
Ernest	imię
Ernesta	imię
Ernestyn	imię
Ernestyna	imię
Eros	imię
Erwin	imię
Erwina	imię
Eryczek	imię
Eryk	imię
Eryka	imię
Eskulap	imię
Esperanca	imię
Essex	nazwisko
Estera	imię
Esterházy	nazwisko
Esterka	imię
Estreicher	nazwisko
Euchariusz	imię
Eudocja	imię
Eudokia	imię
Eudokim	imię
Eudoksja	imię
Eudoksjusz	imię
Eufemia	imię
Eufrazy	imię
Eufrozyna	imię
Eugenia	imię
Eugeniusz	imię
Euklides	imię
Eulalia	imię
Euler	nazwisko
Eulogiusz	imię
Eurydyka	imię
Eurypides	imię
Eustachiusz	imię
Eustachy	imię
Eutropiusz	imię
Euzebia	imię
Euzebiusz	imię
Ewa	imię
Ewald	imię
Ewaryst	imię
Ewcia	imię
Ewdokia	imię
Ewelin	imię
Ewelina	imię
Eweryst	imię
Ewka	imię
Ewodia	imię
Ewunia	imię
Ewusia	imię
Exupéry	nazwisko
Eysymontt	nazwisko
Ezaw	imię
Ezdrasz	imię
Ezechiasz	imię
Ezechiel	imię
Ezop	imię
Faber	nazwisko
Fabia	imię
Fabian	imię
Fabiola	imię
Fabiszewska	nazwisko
Fabiszewski	nazwisko
Fabiusz	imię
Fabrycjan	imię
Fabrycjusz	imię
Fabrycy	imię
Faeton	imię
Fahrenheit	nazwisko
Falacci	nazwisko
Falandysz	nazwisko
Falk	imię
Falkowska	nazwisko
Falkowski	nazwisko
Faraday	nazwisko
Fatima	imię|geograficzna
Fatyga	nazwisko
Faulkner	nazwisko
Faure	nazwisko
Faust	imię
Fausta	imię
Faustyn	imię
Faustyna	imię
Fayette	nazwisko
Fałat	nazwisko
Febus	imię
Fedorko	nazwisko
Fedorowicz	nazwisko
Fela	imię
Felcia	imię
Felczak	nazwisko
Felek	imię
Feleszko	nazwisko
Felicja	imię
Felicjan	imię
Felicysym	imię
Felicyta	imię
Feliks	imię
Feliksa	imię
Felka	imię
Fellini	nazwisko
Felusia	imię
Feluś	imię
Feniks	imię
Ferdek	imię
Ferdynand	imię
Ferdzik	imię
Ferreira	nazwisko
Festus	imię
Feuerbach	nazwisko
Fibak	nazwisko
Fichte	nazwisko
Fidel	imię
Fidelis	imię
Fides	imię
Fidiasz	imię
Fiedler	nazwisko
Fieldorf	nazwisko
Figarska	nazwisko
Figarski	nazwisko
Figura	nazwisko
Figurska	nazwisko
Figurski	nazwisko
Fijałkowska	nazwisko
Fijałkowski	nazwisko
Fikus	imię
Fil	imię
Fila	imię
Filek	imię
Filemon	imię
Filip	imię
Filipa	imię
Filipek	imię
Filipiak	nazwisko
Filipina	imię
Filipowicz	nazwisko
Filomen	imię
Filomena	imię
Filon	imię
Filuś	imię
Fiodor	imię
Firko	nazwisko
Firlej	nazwisko
Fischer	nazwisko
Fitelberg	nazwisko
Fitzgerald	nazwisko
Fizia	imię
Flaubert	nazwisko
Flawia	imię
Flawian	imię
Flawiusz	imię
Fleming	nazwisko
Fleszarowa	nazwisko
Flisowska	nazwisko
Flisowski	nazwisko
Flora	imię
Florczak	nazwisko
Florek	imię
Florencjusz	imię
Florenty	imię
Florentyn	imię
Florentyna	imię
Florian	imię
Floryn	imię
Fo	nazwisko
Foch	nazwisko
Focjusz	imię
Fogg	nazwisko
Fonda	nazwisko
Fonseca	nazwisko
Fonsik	imię
Fonsio	imię
Fontaine	nazwisko
Ford	nazwisko
Forman	nazwisko
Forsyth	nazwisko
Forsythe	nazwisko
Fortunat	imię
Fortunata	imię
Foucault	nazwisko
Fourier	nazwisko
Fragonard	nazwisko
France	nazwisko
Francek	imię
Francik	imię
Franciszek	imię
Franciszka	imię
Franck	nazwisko
Franco	nazwisko
Francois	imię
Franek	imię
Frania	imię
Franio	imię
Frank	imię
Frankenstein	nazwisko
Frankiewicz	nazwisko
Franklin	nazwisko
Frankowska	nazwisko
Frankowski	nazwisko
Franuś	imię
Franz	imię
Frassati	nazwisko
Frasyniuk	nazwisko
Fred	imię
Freda	imię
Fredek	imię
Fredka	imię
Fredro	nazwisko
Fredzio	imię
Frenkiel	nazwisko
Freud	nazwisko
Friedman	nazwisko
Friedrich	nazwisko|imię
Frisch	nazwisko
Fritz	imię
Froelich	nazwisko
Fromm	nazwisko
Froncek	imię
Fronczewski	nazwisko
Frumencjusz	imię
Fryc	imię
Frycek	imię
Frycz	nazwisko
Fryda	imię
Frydek	imię
Fryderyczek	imię
Fryderyk	imię
Fryderyka	imię
Frydolin	imię
Frydzio	imię
Frąckowiak	nazwisko
Frączak	nazwisko
Frączek	nazwisko
Frątczak	nazwisko
Fulbright	nazwisko
Funes	nazwisko
Funk	nazwisko
Furia	imię
Gaba	imię
Gabi	imię
Gabin	nazwisko|imię
Gable	nazwisko
Gabor	imię
Gabriel	imię
Gabriela	imię
Gabrielka	imię
Gabriella	imię
Gabrysia	imię
Gabryś	imię
Gabryśka	imię
Gacka	nazwisko
Gacki	nazwisko|geograficzna
Gad	nazwisko|imię
Gadawski	nazwisko
Gadomska	nazwisko
Gadomski	nazwisko
Gagarin	nazwisko
Gainsborough	nazwisko
Gaj	nazwisko|geograficzna
Gaja	imię
Gajcy	nazwisko
Gajda	nazwisko
Gajdar	nazwisko
Gajewska	nazwisko
Gajewski	nazwisko
Gajowianka	nazwisko
Gajusz	imię
Galata	nazwisko|geograficzna
Galatasaray	organizacja|nazwisko
Galbraith	nazwisko
Galezy	imię
Galica	nazwisko
Galileusz	nazwisko
Galińska	nazwisko
Galiński	nazwisko
Galla	imię
Gallina	imię
Gallup	nazwisko
Galsworthy	nazwisko
Galvani	nazwisko
Gama	nazwisko
Gamaliel	imię
Gandhi	nazwisko
Gara	nazwisko
Garbarz	nazwisko
Garbo	nazwisko
Garcia	nazwisko|imię
Garczyński	nazwisko
Gard	nazwisko
Gargantua	imię
Garibaldi	nazwisko
Garros	nazwisko
Gaspar	imię
Gates	nazwisko
Gaudencja	imię
Gaudencjusz	imię
Gaudenty	imię
Gaudí	nazwisko
Gauguin	nazwisko
Gaulle	nazwisko
Gauss	nazwisko
Gautier	nazwisko
Gaweł	imię
Gawle	nazwisko
Gawlik	nazwisko
Gawron	nazwisko
Gawrońska	nazwisko
Gawroński	nazwisko
Gawryła	imię
Gawła	imię
Gawłowska	nazwisko
Gawłowski	nazwisko
Gay	nazwisko
Gałażewski	nazwisko
Gałczyńska	nazwisko
Gałczyński	nazwisko
Gałdyn	nazwisko
Gałecka	nazwisko
Gałecki	nazwisko
Gałkowska	nazwisko
Gałkowski	nazwisko
Gałoński	nazwisko
Gdowik	nazwisko
Gebethner	nazwisko
Gebhard	imię
Gedeon	imię
Geiger	nazwisko
Genek	imię
Genet	nazwisko
Genia	imię
Genio	imię
Gennes	nazwisko
Genowefa	imię
George	pseudonim|nazwisko|imię
Georges	imię
Georgij	imię
Georgina	imię
Gerald	imię
Geraldyna	imię
Gerard	imię
Gerarda	imię
Gerazym	imię
Geremek	nazwisko
Gereon	imię
Gerhard	imię
German	imię
Germanik	imię
Gershwin	nazwisko
Gerson	nazwisko|imię
Gerta	imię
Gertruda	imię
Gerwazy	imię
Ghali	nazwisko
Ghelderode	nazwisko
Gide	nazwisko
Giedroyc	nazwisko
Giedroyć	nazwisko
Giedymin	imię
Gielarowski	nazwisko
Gielgud	nazwisko
Gienek	imię
Gienia	imię
Gienio	imię
Gieniuchna	imię
Gienka	imię
Gierek	nazwisko
Gierka	imię
Gierlicki	nazwisko
Giertych	nazwisko
Gierymski	nazwisko
Gieysztor	nazwisko
Gieńka	imię
Gil	nazwisko
Gilbert	imię
Gilda	imię
Gillespie	nazwisko
Gilski	nazwisko
Ginsberg	nazwisko
Ginter	imię
Giordano	imię
Giorgione	nazwisko
Giotto	nazwisko
Giraudoux	nazwisko
Giscard	nazwisko
Giuseppe	imię
Gizela	imię
Gizińska	nazwisko
Giziński	nazwisko
Glapińska	nazwisko
Glapiński	nazwisko
Gleb	imię
Glemp	nazwisko
Glinka	nazwisko|geograficzna
Gliwicka	nazwisko
Glińska	nazwisko
Gliński	nazwisko
Gloger	nazwisko
Gloria	imię
Glotz	nazwisko
Gluck	nazwisko
Gneisenau	nazwisko
Gniewomir	imię
Gniewosz	imię
Gnutek	nazwisko
Goar	imię
Gocisław	imię
Goclon	nazwisko
Gocman	nazwisko
Gocłowska	nazwisko
Gocłowski	nazwisko
Godebska	nazwisko
Godebski	nazwisko
Godfrey	imię
Godfryd	imię
Godlewska	nazwisko
Godlewski	nazwisko
Godunow	nazwisko
Godziek	nazwisko
Godzimir	imię
Godzisz	imię
Godzisław	imię
Godzisława	imię
Goebbels	nazwisko
Goetel	nazwisko
Goethe	nazwisko
Gogh	nazwisko
Gogol	nazwisko
Gojawiczyńska	nazwisko
Gojawiczyński	nazwisko
Gola	nazwisko
Golańska	nazwisko
Golański	nazwisko
Golda	imię
Goldberger	nazwisko
Goldoni	nazwisko
Golec	nazwisko
Golecka	nazwisko
Golecki	nazwisko
Golem	imię
Goleniowski	nazwisko
Gollob	nazwisko
Goluch	nazwisko
Gombrowicz	nazwisko
Gomułka	nazwisko
Gomółka	nazwisko
Goncourt	nazwisko
Gongadze	nazwisko
Gontarska	nazwisko
Gontarski	nazwisko
Goraj	nazwisko|geograficzna
Gorazd	imię
Gorbaczow	nazwisko
Gorgoncjusz	imię
Gorki	nazwisko
Gorlicki	nazwisko
Goryszewska	nazwisko
Goryszewski	nazwisko
Gorzynik	nazwisko
Gorzysław	imię
Gosia	imię
Gosieńka	imię
Goszcz	nazwisko|geograficzna
Gosław	imię
Gosławska	nazwisko
Gosławski	nazwisko
Got	nazwisko
Gotard	imię
Gotfryd	imię
Goth	nazwisko
Gottwald	nazwisko
Gounod	nazwisko
Goya	nazwisko
Gołaszewska	nazwisko
Gołaszewski	nazwisko
Gołda	imię
Gołdynia	nazwisko
Gołdyń	nazwisko
Gołogórski	nazwisko
Gołota	nazwisko
Gołubiew	nazwisko
Gołąb	nazwisko|geograficzna
Gołębiewska	nazwisko
Gołębiewski	nazwisko
Gołębiowska	nazwisko
Gołębiowski	nazwisko
Gościmir	imię
Gościmił	imię
Gościrad	imię
Gościsław	imię
Gościsława	imię
Gościwit	imię
Gośka	imię
Grabarczyk	nazwisko
Grabczyk	nazwisko
Grabicka	nazwisko
Grabińska	nazwisko
Grabiński	nazwisko
Grabowska	nazwisko
Grabowski	nazwisko
Grabska	nazwisko
Grabski	nazwisko
Gracja	imię
Gracjan	imię
Gracjana	imię
Gracq	nazwisko
Gracz	nazwisko
Graczow	nazwisko
Graczyk	nazwisko
Graham	nazwisko
Gralec	nazwisko
Gramsci	nazwisko
Grant	nazwisko
Grappin	nazwisko
Grass	nazwisko
Gratkowski	nazwisko
Graves	nazwisko
Grażyna	imię
Grechuta	nazwisko
Greco	nazwisko
Gregorski	nazwisko
Gregory	imię
Gresham	nazwisko
Greta	imię
Gribojedow	nazwisko
Grieg	nazwisko
Griffith	nazwisko
Grigorij	imię
Grimm	nazwisko
Grisza	imię
Grobelna	nazwisko
Grobelny	nazwisko
Groblicz	nazwisko
Grochola	nazwisko
Grochowiak	nazwisko
Grochowska	nazwisko
Grochowski	nazwisko
Groddeck	nazwisko
Grodecka	nazwisko
Grodecki	nazwisko
Grodzisław	imię
Gromczak	nazwisko
Gromosław	imię
Gromyko	nazwisko
Gronholm	nazwisko
Gronkiewicz	nazwisko
Gropius	nazwisko
Gross	nazwisko
Grot	nazwisko
Grotowska	nazwisko
Grotowski	nazwisko
Grottger	nazwisko
Gruca	nazwisko
Grudzień	nazwisko
Grudzińska	nazwisko
Grudziński	nazwisko
Grunwaldzka	nazwisko
Grunwaldzki	nazwisko
Grusza	nazwisko
Gruszczyńska	nazwisko
Gruszczyński	nazwisko
Gruszecka	nazwisko
Gruszecki	nazwisko
Gruszka	nazwisko
Gruszowski	nazwisko
Grygolec	nazwisko
Grywalski	nazwisko
Gryzelda	imię
Gryzło	nazwisko
Gryźlak	nazwisko
Grzech	imię
Grzegorczyk	nazwisko
Grzegorczykowa	nazwisko
Grzegorz	imię
Grzegórzecka	nazwisko
Grzegórzecki	nazwisko
Grzelak	nazwisko
Grzesiak	nazwisko
Grzesiek	imię
Grzesio	imię
Grześ	imię
Grześkowiak	nazwisko
Grzyb	nazwisko
Grzybowska	nazwisko
Grzybowski	nazwisko
Grzymała	nazwisko
Grzymisław	imię
Grzymisława	imię
Grądalska	nazwisko
Grębowski	nazwisko
Guarneri	nazwisko
Gucci	nazwisko
Gucio	imię
Gucwiński	nazwisko
Gudecki	nazwisko
Guenter	imię
Guevara	nazwisko
Guliwer	imię
Gustaw	imię
Gustawa	imię
Gustawek	imię
Gustek	imię
Guta	imię
Gutek	imię
Gutenberg	nazwisko
Gutkind	imię
Gutkowska	nazwisko
Gutkowski	nazwisko
Gutman	imię
Gutowska	nazwisko
Gutowski	nazwisko
Guzowska	nazwisko
Guzowski	nazwisko
Gwalbert	imię
Gwido	imię
Gwidon	imię
Góra	nazwisko
Górczyńska	nazwisko
Górczyński	nazwisko
Górecka	nazwisko
Górecki	nazwisko
Górka	nazwisko|geograficzna
Górniak	nazwisko
Górny	nazwisko
Górski	nazwisko
Górzyńska	nazwisko
Górzyński	nazwisko
Günter	imię
Gąsienica	nazwisko
Gąsiorowska	nazwisko
Gąsiorowski	nazwisko
Gąsowska	nazwisko
Gąsowski	nazwisko
Gębala	nazwisko
Gębik	nazwisko
Gęsiak	nazwisko
Głowacka	nazwisko
Głowacki	nazwisko
Głowińska	nazwisko
Głowiński	nazwisko
Głęboczek	nazwisko|geograficzna
Habakuk	imię
Hades	imię
Hadrian	imię
Hadyna	nazwisko
Haeckel	nazwisko
Haendel	nazwisko
Haider	nazwisko
Hajduga	nazwisko
Hajdukowa	nazwisko
Hajnos	nazwisko
Hala	imię
Halina	imię
Halinka	imię
Halka	imię
Haller	nazwisko
Halley	nazwisko
Halszka	imię
Halusia	imię
Hamilton	nazwisko|geograficzna
Hammond	nazwisko
Hammurabi	imię
Hamsun	nazwisko
Hanausek	nazwisko
Handke	nazwisko
Handzel	nazwisko
Haneczka	imię
Hania	imię
Hanka	imię
Hanna	imię
Hannawald	nazwisko
Hannibal	imię
Hans	imię
Hanula	imię
Hanusia	imię
Hanuszkiewicz	nazwisko
Harasym	imię
Harasymowicz	nazwisko
Hardy	nazwisko
Harrison	nazwisko
Harry	imię
Harvard	nazwisko|instytucja
Has	nazwisko
Hasior	nazwisko
Hasmoneusz	imię
Haszek	nazwisko
Hauser	nazwisko
Hautamaeki	nazwisko
Havel	nazwisko
Hawełka	nazwisko
Haydn	nazwisko
Hańcza	nazwisko|geograficzna
Hański	nazwisko
Heaney	nazwisko
Hefajstos	imię
Hegel	nazwisko
Hegezyp	imię
Heidegger	nazwisko
Heine	nazwisko
Hejnar	nazwisko
Hektor	imię
Hela	imię
Helcel	nazwisko
Helcia	imię
Helena	imię
Helenka	imię
Helga	imię
Heliasz	imię
Helidor	imię
Heliodor	imię
Helios	imię
Helka	imię
Heller	nazwisko
Helmut	imię
Heloiza	imię
Helusia	imię
Hemar	nazwisko
Hemingway	nazwisko
Hena	imię
Hendel	imię
Hendrix	nazwisko
Hendzel	nazwisko
Henia	imię
Heniek	imię
Henio	imię
Hennelowa	nazwisko
Henoch	imię
Henry	imię
Henryczek	imię
Henryczka	imię
Henryk	imię
Henryka	imię
Henrysia	imię
Henryś	imię
Hepburn	nazwisko
Hera	imię
Herakles	imię
Herakliusz	imię
Herald	imię
Herbert	nazwisko|imię
Herc	nazwisko
Hercen	nazwisko
Herder	nazwisko
Herkulan	imię
Herkules	imię
Herling	nazwisko
Herman	imię
Hermaniuk	nazwisko
Hermanowa	nazwisko
Hermenegild	imię
Hermenegilda	imię
Hermes	imię
Hermina	imię
Herminia	imię
Herod	imię
Herodot	imię
Herschel	nazwisko
Hersz	imię
Hertha	imię
Hertz	nazwisko
Herzog	nazwisko
Hesse	nazwisko
Heweliusz	nazwisko
Heyerdahl	nazwisko
Hełdak	nazwisko
Hiacynt	imię
Hiacynta	imię
Hieronim	imię
Hilaria	imię
Hilarion	imię
Hilary	imię
Hildegarda	imię
Hill	pseudonim|nazwisko
Hillary	imię
Himilsbach	nazwisko
Himmler	nazwisko
Hindemith	nazwisko
Hindenburg	nazwisko
Hiob	imię
Hipcio	imię
Hipek	imię
Hipokrates	imię
Hipolit	imię
Hipolita	imię
Hirek	imię
Hirsz	imię
Hirszfeld	nazwisko
Hitchcock	nazwisko
Hitler	nazwisko
Hlond	nazwisko
Hobbes	nazwisko
Hodana	nazwisko
Hoene	nazwisko
Hoffman	nazwisko
Hoffmann	nazwisko
Hoffmanowa	nazwisko
Hofman	nazwisko
Hogarth	nazwisko
Holbein	nazwisko
Holland	nazwisko
Holmes	nazwisko
Holocher	nazwisko
Holoubek	nazwisko
Holyfield	nazwisko
Homer	imię
Honecker	nazwisko
Honegger	nazwisko
Honorat	imię
Honorata	imię
Honoratka	imię
Honorcia	imię
Honoriusz	imię
Honorka	imię
Honory	imię
Honoryna	imię
Hoover	nazwisko
Hoppe	nazwisko
Horacjusz	imię
Horacy	imię
Horngacher	nazwisko
Horowitz	nazwisko
Horst	imię
Hortensja	imię
Hortensjusz	imię
Horthy	nazwisko
Hortmanowicz	nazwisko
Horzyca	nazwisko
Hozjusz	nazwisko
Hrabal	nazwisko
Hryniewicz	nazwisko
Hubble	nazwisko
Hubercik	imię
Hubert	imię
Huberta	imię
Hudson	nazwisko|geograficzna
Hudyka	nazwisko
Huelle	nazwisko
Hugo	nazwisko|imię
Hugon	imię
Hugues	nazwisko
Humboldt	nazwisko
Humer	nazwisko
Hunyady	nazwisko
Hus	nazwisko
Husajn	nazwisko
Husak	nazwisko
Husejko	nazwisko
Husserl	nazwisko
Huszcza	nazwisko
Huxley	nazwisko
Hygin	imię
Hymen	imię
Hynowski	nazwisko
Hłasko	nazwisko
Ibrahim	imię
Ibsen	nazwisko
Icchak	imię
Icek	imię
Ida	imię
Idalia	imię
Idzi	imię
Idzikowska	nazwisko
Idzikowski	nazwisko
Ifigenia	imię
Iga	imię
Iglesias	nazwisko
Ignacek	imię
Ignacja	imię
Ignacy	imię
Ignaś	imię
Igor	imię
Igorek	imię
Iguś	imię
Iheanacho	nazwisko
Ikar	imię
Iksińska	nazwisko
Iksiński	nazwisko
Ildefons	imię
Ildefonsik	imię
Ileczko	nazwisko
Ilia	imię
Ilja	imię
Ilona	imię
Ilza	imię
Imisław	imię
Imisława	imię
Immanuel	imię
Immelmann	nazwisko
Imre	imię
Indra	imię
Inga	imię
Ingarden	nazwisko
Ingmar	imię
Ingres	nazwisko
Ingrid	imię
Inka	imię
Innocenta	imię
Innocenty	imię
Inoziemcew	nazwisko
Ionesco	nazwisko
Ira	imię
Ircia	imię
Ireczek	imię
Irek	imię
Irena	imię
Ireneusz	imię
Irenka	imię
Irina	imię
Iris	imię
Irka	imię
Irma	imię
Irmina	imię
Irusia	imię
Iruś	imię
Irvine	imię
Irwin	imię
Iryda	imię
Irydion	imię
Irzykowska	nazwisko
Irzykowski	nazwisko
Isaak	imię
Iser	imię
Issachar	imię
Ita	imię
Ivan	imię
Iverson	nazwisko
Iwa	imię
Iwan	imię
Iwanow	nazwisko
Iwanowska	nazwisko
Iwanowski	nazwisko
Iwaszkiewicz	nazwisko
Iwańska	nazwisko
Iwański	nazwisko
Iweta	imię
Iwetta	imię
Iwińska	nazwisko
Iwiński	nazwisko
Iwo	imię
Iwon	imię
Iwona	imię
Iwonka	imię
Iwonna	imię
Iza	imię
Izaak	imię
Izabela	imię
Izabella	imię
Izajasz	imię
Izdebska	nazwisko
Izdebski	nazwisko
Izia	imię
Izolda	imię
Izrael	imię|geograficzna
Izunia	imię
Izyda	imię
Izydor	imię
Izydorek	imię
Iłłakowiczówna	nazwisko
Jaabes	imię
Jabłońska	nazwisko
Jabłoński	nazwisko
Jacek	imię
Jacenty	imię
Jachowicz	nazwisko
Jack	imię
Jackiewicz	nazwisko
Jackowska	nazwisko
Jackowski	nazwisko
Jackson	nazwisko
Jacobson	nazwisko
Jacques	imię
Jacuś	imię
Jaczewoj	imię
Jaczewska	nazwisko
Jaczewski	nazwisko
Jadwiga	imię
Jadwinia	imię
Jadwisia	imię
Jadwiśka	imię
Jadwiźka	imię
Jadwiżka	imię
Jadzia	imię
Jadziunia	imię
Jadźka	imię
Jafet	imię
Jaga	imię
Jagger	nazwisko
Jagielska	nazwisko
Jagielski	nazwisko
Jagienka	imię
Jagiełło	nazwisko
Jaglińska	nazwisko
Jagliński	nazwisko
Jagna	imię
Jagoda	imię
Jagodzińska	nazwisko
Jagodziński	nazwisko
Jagunia	imię
Jagusia	imię
Jaguśka	imię
Jahn	nazwisko
Jahwe	imię
Jaje	nazwisko
Jakir	imię
Jakobina	imię
Jakobsze	nazwisko
Jakowlew	nazwisko
Jakub	imię
Jakubczyk	nazwisko
Jakubek	imię
Jakubiak	nazwisko
Jakubowska	nazwisko
Jakubowski	nazwisko
Jambroży	imię
James	nazwisko
Jan	imię
Janczak	nazwisko
Janczewska	nazwisko
Janczewski	nazwisko
Janda	nazwisko
Janeczka	imię
Janek	imię
Janiak	nazwisko
Janicka	nazwisko
Janicki	nazwisko
Janik	nazwisko
Janina	imię
Janion	nazwisko
Janiszewska	nazwisko
Janiszewski	nazwisko
Janisław	imię
Janka	imię
Jankiel	imię
Jankiewicz	nazwisko
Janko	imię
Jankowiak	nazwisko
Jankowska	nazwisko
Jankowski	nazwisko
Janosik	imię
Janosz	nazwisko|imię
Janowicz	nazwisko
Janowska	nazwisko
Janowski	nazwisko
Jantar	nazwisko|geograficzna
Jantek	imię
Jantosia	imię
Jantośka	imię
Jantuś	imię
Januaria	imię
Januariusz	imię
January	imię
Janusz	imię
Januszek	imię
Januszewska	nazwisko
Januszewski	nazwisko
Janów	nazwisko|geograficzna
Jaques	nazwisko
Jaracz	nazwisko
Jaranowska	nazwisko
Jaranowski	nazwisko
Jareczek	imię
Jarek	imię
Jarema	nazwisko|imię
Jarka	imię
Jarogniew	imię
Jaromir	imię
Jaropełk	imię
Jarosińska	nazwisko
Jarosiński	nazwisko
Jarossy	nazwisko
Jarosz	nazwisko
Jaroszewicz	nazwisko
Jaroszewska	nazwisko
Jaroszewski	nazwisko
Jaroszyńska	nazwisko
Jaroszyński	nazwisko
Jarosław	imię|geograficzna
Jarosława	imię
Jarre	nazwisko
Jarry	nazwisko
Jaruzelska	nazwisko
Jaruzelski	nazwisko
Jaruś	imię
Jarvis	nazwisko
Jarzyńska	nazwisko
Jarzyński	nazwisko
Jarzębska	nazwisko
Jarzębski	nazwisko
Jaser	imię
Jasia	imię
Jasieczek	imię
Jasiek	imię
Jasienica	pseudonim|nazwisko|geograficzna
Jasieńska	nazwisko
Jasieński	nazwisko
Jasio	imię
Jasińska	nazwisko
Jasiński	nazwisko
Jaskołd	imię
Jaskulska	nazwisko
Jaskulski	nazwisko
Jaskólska	nazwisko
Jaskólski	nazwisko
Jasnorzewska	nazwisko
Jasnorzewski	nazwisko
Jaspers	nazwisko
Jastrun	nazwisko
Jastrząb	nazwisko
Jastrzębska	nazwisko
Jastrzębski	nazwisko
Jaworek	nazwisko|geograficzna
Jaworska	nazwisko
Jaworski	nazwisko
Jaxa	nazwisko
Jazon	imię
Jaś	imię
Jaśka	imię
Jaśkiewicz	nazwisko
Jaśko	imię
Jaśkowska	nazwisko
Jaśkowski	nazwisko
Jean	imię
Jefferson	nazwisko
Jegor	imię
Jehoszua	imię
Jehowa	imię
Jehuda	imię
Jeir	imię
Jelcyn	nazwisko
Jelena	imię
Jeleńska	nazwisko
Jeleński	nazwisko
Jelonek	nazwisko|geograficzna
Jenny	imię
Jens	imię
Jeremi	imię
Jeremiasz	imię
Jeron	imię
Jerosława	imię
Jerzy	imię
Jerzyk	imię
Jesienin	nazwisko
Jeszua	imię
Jewdocha	imię
Jewtuszenko	nazwisko
Jezajasz	imię
Jeziorańska	nazwisko
Jeziorański	nazwisko
Jeziorska	nazwisko
Jeziorski	nazwisko
Jezus	imię
Jim	imię
Jimmy	imię
Jiři	imię
Joab	imię
Joachim	imię
Joachima	imię
Joachimek	imię
Joanna	imię
Joas	imię
Joasia	imię
Joaśka	imię
Job	imię
Jochanan	imię
Jochebed	imię
Jodłowska	nazwisko
Jodłowski	nazwisko
Joe	imię
Joel	imię
Joey	imię
Johannes	imię
John	nazwisko|imię
Johnson	nazwisko
Johnston	nazwisko|geograficzna
Jokai	nazwisko
Jola	imię
Jolanta	imię
Jolka	imię
Jonasz	imię
Jonatan	imię
Jones	nazwisko
Jontek	imię
Jordan	nazwisko|imię|geograficzna
Jose	imię
Josek	imię
Joselewicz	nazwisko
Joseph	imię
Joshua	imię
Joszua	imię
Joule	nazwisko
Jowisz	imię|astr.
Jowita	imię
Joyce	nazwisko
Jozafat	imię
Jozafata	imię
Jozue	imię
Juarez	nazwisko
Juda	imię
Judyta	imię
Judytka	imię
Jul	imię
Jula	imię
Julcia	imię
Julek	imię
Julia	imię
Julian	imię
Juliana	imię
Julianna	imię
Julietta	imię
Julita	imię
Juliusz	imię
Julka	imię
Julo	imię
Jundziłł	nazwisko
Jundziłło	nazwisko
Jung	nazwisko
Jungingen	nazwisko
Junosza	nazwisko
Jupiter	imię
Jur	imię
Jura	imię
Jurand	imię
Jurata	imię|geograficzna
Jurczak	nazwisko
Jurczyk	nazwisko
Jureczek	imię
Jurek	nazwisko|imię
Jurij	imię
Jurkiewicz	nazwisko
Jurkowska	nazwisko
Jurkowski	nazwisko
Just	imię
Justyn	imię
Justyna	imię
Justynian	imię
Justynka	imię
Justysia	imię
Juszczak	nazwisko
Juszczyk	nazwisko
Józafat	imię
Józeczek	imię
Józef	imię
Józefa	imię
Józefek	imię
Józefina	imię
Józek	imię
Józia	imię
Józiek	imię
Józik	imię
Józio	imię
Józka	imię
Józuś	imię
Józwa	imię
Jóźko	imię
Jóźwiak	nazwisko
Jędrek	imię
Jędruś	imię
Jędrychowska	nazwisko
Jędrychowski	nazwisko
Jędrzej	imię
Jędrzejczak	nazwisko
Jędrzejczyk	nazwisko
Jędrzejek	imię
Jędrzejewska	nazwisko
Jędrzejewski	nazwisko
Kacha	imię
Kachna	imię
Kacper	imię
Kacperek	imię
Kacperska	nazwisko
Kacperski	nazwisko
Kacprzak	nazwisko
Kaczanowska	nazwisko
Kaczanowski	nazwisko
Kaczkowska	nazwisko
Kaczkowski	nazwisko
Kaczmarczyk	nazwisko
Kaczmarek	nazwisko
Kaczmarska	nazwisko
Kaczmarski	nazwisko
Kaczor	nazwisko
Kaczorowska	nazwisko
Kaczorowski	nazwisko
Kaczyńska	nazwisko
Kaczyński	nazwisko
Kada	imię
Kadafi	nazwisko
Kadar	nazwisko
Kaden	pseudonim|nazwisko
Kadenacy	nazwisko
Kadmon	imię
Kadysz	imię
Kadłubek	przydomek|nazwisko
Kafka	nazwisko
Kain	imię
Kaj-szek	nazwisko
Kaja	imię
Kajetan	imię
Kajetanek	imię
Kajfasz	imię
Kajka	nazwisko
Kajtek	imię
Kajus	imię
Kalabińska	nazwisko
Kalabiński	nazwisko
Kalasanty	imię
Kali	imię
Kalicka	nazwisko
Kalicki	nazwisko
Kaligula	imię
Kalikast	imię
Kalikst	imię
Kaliksta	imię
Kalimach	imię
Kalina	imię
Kalinik	imię
Kalinowska	nazwisko
Kalinowski	nazwisko
Kaliope	imię
Kalistrat	imię
Kaliszewska	nazwisko
Kaliszewski	nazwisko
Kalińska	nazwisko
Kaliński	nazwisko
Kallimach	imię
Kallina	imię
Kalman	imię
Kalwin	nazwisko
Kamel	nazwisko
Kamieńska	nazwisko
Kamieński	nazwisko
Kamil	imię
Kamila	imię
Kamińska	nazwisko
Kamiński	nazwisko
Kammsetzer	nazwisko
Kamyk	nazwisko|geograficzna
Kandinsky	nazwisko
Kandyd	imię
Kania	nazwisko
Kaniewska	nazwisko
Kaniewski	nazwisko
Kanizjusz	imię
Kant	nazwisko
Kantor	nazwisko
Kanty	imię
Kanut	imię
Kapczyńska	nazwisko
Kapczyński	nazwisko
Kapuścińska	nazwisko
Kapuściński	nazwisko
Karajan	nazwisko
Karamazow	nazwisko
Karasińska	nazwisko
Karasiński	nazwisko
Karczewski	nazwisko
Karen	imię
Karenina	nazwisko
Karina	imię
Karinka	imię
Karkowska	nazwisko
Karkowski	nazwisko
Karl	imię
Karliczek	imię
Karlik	imię
Karmen	imię
Karol	imię
Karolak	nazwisko
Karolcia	imię
Karolek	imię
Karolin	imię
Karolina	imię
Karolinka	imię
Karolka	imię
Karp	imię
Karpińska	nazwisko
Karpiński	nazwisko
Karpow	nazwisko
Karpowicz	nazwisko
Kartezjusz	nazwisko
Karusia	imię
Karwowska	nazwisko
Karwowski	nazwisko
Karłowicz	nazwisko
Kasandra	imię
Kasia	imię
Kasica	nazwisko
Kasieńka	imię
Kasinka	imię
Kasińska	nazwisko
Kasiński	nazwisko
Kasjan	imię
Kasjusz	imię
Kasparow	nazwisko
Kasper	imię
Kasperek	imię
Kasprowicz	nazwisko
Kaspruś	imię
Kasprzak	nazwisko
Kasprzyk	nazwisko
Kastor	imię
Kaszyńska	nazwisko
Kaszyński	nazwisko
Katarzyna	imię
Kato	imię
Katon	imię
Kaufman	imię
Kawalec	nazwisko
Kawczyńska	nazwisko
Kawczyński	nazwisko
Kawecka	nazwisko
Kawecki	nazwisko
Kazan	nazwisko
Kazek	imię
Kazia	imię
Kazik	imię
Kazimiera	imię
Kazimierczak	nazwisko
Kazimierowska	nazwisko
Kazimierowski	nazwisko
Kazimierz	imię|geograficzna
Kazio	imię
Kaziuk	imię
Kazka	imię
Kazko	imię
Kałużny	nazwisko
Kałużyńska	nazwisko
Kałużyński	nazwisko
Kaśka	imię
Kaźko	imię
Kaźmierczak	nazwisko
Kefas	imię
Keith	imię
Keller	nazwisko
Kelles	nazwisko
Kellogg	nazwisko
Kelvin	nazwisko
Kempińska	nazwisko
Kempiński	nazwisko
Kenar	nazwisko
Kennedy	nazwisko
Kenneth	imię|geograficzna
Kern	nazwisko
Kevin	imię
Keynes	nazwisko
Khan	nazwisko
Kicińska	nazwisko
Kiciński	nazwisko
Kidawa	nazwisko
Kiejstut	imię
Kiejstutowicz	nazwisko
Kiepura	nazwisko
Kierbedź	nazwisko
Kiereński	nazwisko
Kierkegaard	nazwisko
Kierzkowska	nazwisko
Kierzkowski	nazwisko
Kieszkowska	nazwisko
Kieszkowski	nazwisko
Kietlińska	nazwisko
Kietliński	nazwisko
Kiełbasa	nazwisko
Kiełczewska	nazwisko
Kiełczewski	nazwisko
Kieślowska	nazwisko
Kieślowski	nazwisko
Kijowska	nazwisko
Kijowski	nazwisko
Kilar	nazwisko
Kilian	imię
Kiliński	nazwisko
Kiljańska	nazwisko
Kiljański	nazwisko
King	nazwisko
Kinga	imię
Kingusia	imię
Kinia	imię
Kipling	nazwisko
Kir	imię
Kira	imię
Kirk	nazwisko|imię
Kirke	imię
Kirył	imię
Kisiel	nazwisko
Kisielewicz	nazwisko
Kisielewska	nazwisko
Kisielewski	nazwisko
Kissinger	nazwisko
Kiszczak	nazwisko
Kiszło	nazwisko
Kitowicz	nazwisko
Klaczko	nazwisko
Klara	imię
Klarcia	imię
Klarusia	imię
Klarysa	imię
Klaudia	imię
Klaudian	imię
Klaudiusz	imię
Klaudyna	imię
Klaudynka	imię
Klaus	imię
Kleczkowska	nazwisko
Kleczkowski	nazwisko
Klee	nazwisko
Kleeberg	nazwisko
Kleiner	nazwisko
Kleist	nazwisko
Klemencja	imię
Klemens	imię
Klemensiewicz	nazwisko
Klement	imię
Klementyn	imię
Klementyna	imię
Kleniewska	nazwisko
Kleniewski	nazwisko
Kleofas	imię
Kleopatra	imię
Klet	imię
Klimaszewska	nazwisko
Klimaszewski	nazwisko
Klimczak	nazwisko
Klimek	nazwisko|imię
Klio	imię
Klocia	imię
Klonowic	nazwisko
Klonowski	nazwisko
Klotylda	imię
Klucznik	określenie dodatkowe|nazwisko|geograficzna
Kluczyńska	nazwisko
Kluczyński	nazwisko
Kmicic	nazwisko
Knapiusz	nazwisko
Kniaźnin	nazwisko
Kochanowska	nazwisko
Kochanowski	nazwisko
Kochańska	nazwisko
Kochański	nazwisko
Kociszewska	nazwisko
Kociszewski	nazwisko
Kodaly	nazwisko
Kofi	imię
Kohelet	imię
Kohl	nazwisko
Kolasińska	nazwisko
Kolasiński	nazwisko
Kolbe	nazwisko
Kolberg	nazwisko
Kolbuszewska	nazwisko
Kolbuszewski	nazwisko
Koleta	imię
Kolińska	nazwisko
Koliński	nazwisko
Kolumb	nazwisko
Komensky	nazwisko
Komornicka	nazwisko
Komornicki	nazwisko
Komorowska	nazwisko
Komorowski	nazwisko
Konarska	nazwisko
Konarski	nazwisko
Konarzewska	nazwisko
Konarzewski	nazwisko
Konczałowski	nazwisko
Konda	imię
Kondrat	imię
Kondratiuk	nazwisko
Konfucjusz	imię
Koniecpolska	nazwisko
Koniecpolski	nazwisko
Konieczna	nazwisko
Konieczny	nazwisko
Konopka	nazwisko
Konopko	nazwisko
Konopnicka	nazwisko
Konopnicki	nazwisko
Konrad	imię
Konrada	imię
Konradyn	imię
Konradyna	imię
Konstancja	imię|geograficzna
Konstancjusz	imię
Konstans	imię
Konstanty	imię
Konstantyn	imię
Konstantyna	imię|geograficzna
Konwicka	nazwisko
Konwicki	nazwisko
Kopalińska	nazwisko
Kopaliński	nazwisko
Kopcińska	nazwisko
Kopciński	nazwisko
Kopczyńska	nazwisko
Kopczyński	nazwisko
Koper	nazwisko
Kopernik	nazwisko
Koperska	nazwisko
Koperski	nazwisko
Kopeć	nazwisko
Kopiec	nazwisko|geograficzna
Koprowska	nazwisko
Koprowski	nazwisko
Korab	nazwisko
Korbut	nazwisko
Korczak	nazwisko
Korczakowska	nazwisko
Korczakowski	nazwisko
Korczyńska	nazwisko
Korczyński	nazwisko
Kordecki	nazwisko
Kordelia	imię
Kordian	imię
Kordula	imię
Korfanty	nazwisko
Kornel	imię
Korneli	imię
Kornelia	imię
Korneliusz	imię
Kornhauser	nazwisko
Korsakow	nazwisko
Korwin	nazwisko|człon nazwiska (herb)
Korybut	nazwisko|człon nazwiska (herb)
Korzeniewska	nazwisko
Korzeniewski	nazwisko
Korzeniowska	nazwisko
Korzeniowski	nazwisko
Kosecka	nazwisko
Kosecki	nazwisko
Kosek	nazwisko
Kosiec	nazwisko
Kosińska	nazwisko
Kosiński	nazwisko
Kosma	imię
Kossak	nazwisko
Kossakowska	nazwisko
Kossakowski	nazwisko
Kossowska	nazwisko
Kossowski	nazwisko
Kossuth	nazwisko
Kostecka	nazwisko
Kostecki	nazwisko
Kostek	imię
Kostka	nazwisko|imię
Kostrzewa	nazwisko
Kostrzewska	nazwisko
Kostrzewski	nazwisko
Kostusia	imię
Kostuś	imię
Kot	nazwisko
Kotarbińska	nazwisko
Kotarbiński	nazwisko
Kotańska	nazwisko
Kotański	nazwisko
Kotkowska	nazwisko
Kotkowski	nazwisko
Kotowska	nazwisko
Kotowski	nazwisko
Kotsis	nazwisko
Kott	nazwisko
Kotula	nazwisko
Kotulanka	nazwisko
Kotulska	nazwisko
Kotulski	nazwisko
Kovacz	nazwisko
Kowal	nazwisko
Kowala	nazwisko|geograficzna
Kowalcze	nazwisko
Kowalczyk	nazwisko
Kowalewska	nazwisko
Kowalewski	nazwisko
Kowalik	nazwisko
Kowalska	nazwisko
Kowalski	nazwisko
Kozak	nazwisko
Kozakiewicz	nazwisko
Koziarska	nazwisko
Koziarski	nazwisko
Kozietulski	nazwisko
Kozieł	nazwisko
Kozioł	nazwisko
Kozińska	nazwisko
Koziński	nazwisko
Kozyriew	nazwisko
Kozłowska	nazwisko
Kozłowski	nazwisko
Kołakowska	nazwisko
Kołakowski	nazwisko
Kołodko	nazwisko
Kołodziej	nazwisko
Kołodziejczak	nazwisko
Kołodziejczyk	nazwisko
Kołłątaj	nazwisko
Końdzia	imię
Kościa	nazwisko
Kościelska	nazwisko
Kościelski	nazwisko
Kościuszko	nazwisko
Koźmian	nazwisko
Krafftówna	nazwisko
Kraińska	nazwisko
Kraiński	nazwisko
Krajewska	nazwisko
Krajewski	nazwisko
Krak	imię
Krall	nazwisko
Kranjec	nazwisko
Krasicka	nazwisko
Krasicki	nazwisko
Krasińska	nazwisko
Krasiński	nazwisko
Krasnodębska	nazwisko
Krasnodębski	nazwisko
Krasowska	nazwisko
Krasowski	nazwisko
Krasoń	nazwisko
Krasuska	nazwisko
Krasuski	nazwisko
Kraszewska	nazwisko
Kraszewski	nazwisko
Krauz	nazwisko
Krauze	nazwisko
Krawczuk	nazwisko
Krawczyk	nazwisko
Krawczyńska	nazwisko
Krawczyński	nazwisko
Krawiec	nazwisko
Kraśniewska	nazwisko
Kraśniewski	nazwisko
Kreja	nazwisko
Krenz	nazwisko
Kreon	imię
Krescens	imię
Krescensjusz	imię
Kriszna	imię
Krleża	nazwisko
Kromer	nazwisko
Kromwel	nazwisko
Kronid	imię
Kronos	imię
Kruczkowska	nazwisko
Kruczkowski	nazwisko
Kruk	nazwisko
Krukowska	nazwisko
Krukowski	nazwisko
Krupa	nazwisko
Krupińska	nazwisko
Krupiński	nazwisko
Krupska	nazwisko
Krupski	nazwisko
Kruszewska	nazwisko
Kruszewski	nazwisko
Kruszyńska	nazwisko
Kruszyński	nazwisko
Krynicka	nazwisko
Krynicki	nazwisko
Krysia	imię
Krysiak	nazwisko
Krysińska	nazwisko
Krysiński	nazwisko
Kryspin	imię
Kryspina	imię
Krystian	imię
Krystiana	imię
Krystyn	imię
Krystyna	imię
Krystynka	imię
Kryńska	nazwisko
Kryński	nazwisko
Kryśka	imię
Krzaklewska	nazwisko
Krzaklewski	nazwisko
Krzemińska	nazwisko
Krzemiński	nazwisko
Krzeptowski	nazwisko
Krzesimir	imię
Krzesisław	imię
Krzesisława	imię
Krzesińska	nazwisko
Krzesiński	nazwisko
Krzych	imię
Krzycha	imię
Krzysia	imię
Krzysiek	imię
Krzysio	imię
Krzysztof	imię
Krzysztofa	imię
Krzywicka	nazwisko
Krzywicki	nazwisko
Krzywosąd	imię
Krzyś	imię
Krzyśka	imię
Krzyżanowska	nazwisko
Krzyżanowski	nazwisko
Krzyżewska	nazwisko
Krzyżewski	nazwisko
Król	nazwisko
Królak	nazwisko
Królikowska	nazwisko
Królikowski	nazwisko
Ksawera	imię
Ksawery	imię
Ksaweryna	imię
Ksenia	imię
Ksenofont	imię
Kserkses	imię
Książek	nazwisko
Księżak	nazwisko
Księżopolska	nazwisko
Księżopolski	nazwisko
Ksymena	imię
Kuba	imię|geograficzna
Kubacka	nazwisko
Kubacki	nazwisko
Kubala	nazwisko
Kubalska	nazwisko
Kubalski	nazwisko
Kubiak	nazwisko
Kubica	nazwisko
Kubicka	nazwisko
Kubicki	nazwisko
Kubiniec	nazwisko
Kubrick	nazwisko
Kubuś	imię
Kucharczyk	nazwisko
Kucharski	nazwisko
Kucińska	nazwisko
Kuciński	nazwisko
Kuczma	nazwisko
Kuczyńska	nazwisko
Kuczyński	nazwisko
Kucówna	nazwisko
Kudelska	nazwisko
Kudelski	nazwisko
Kujawa	nazwisko
Kukiel	nazwisko
Kukiz	nazwisko
Kuklińska	nazwisko
Kukliński	nazwisko
Kula	nazwisko
Kulczyńska	nazwisko
Kulczyński	nazwisko
Kulesza	nazwisko
Kuligowska	nazwisko
Kuligowski	nazwisko
Kulik	nazwisko
Kulikowska	nazwisko
Kulikowski	nazwisko
Kulisiewicz	nazwisko
Kulińska	nazwisko
Kuliński	nazwisko
Kulmowa	nazwisko
Kuna	imię
Kuncewicz	nazwisko
Kuncewiczowa	nazwisko
Kunda	imię
Kundera	nazwisko
Kundzia	imię
Kunegunda	imię
Kunz	nazwisko
Kupido	imię
Kupidyn	imię
Kuraszkiewicz	nazwisko
Kuratowska	nazwisko
Kuratowski	nazwisko
Kurek	nazwisko
Kurkowska	nazwisko
Kurkowski	nazwisko
Kuropieska	nazwisko
Kurosawa	nazwisko
Kuroń	nazwisko
Kurpisz	nazwisko
Kurt	imię
Kusiak	nazwisko
Kusto	nazwisko
Kusznierewicz	nazwisko
Kutrzeba	nazwisko
Kutuzow	nazwisko
Kutz	nazwisko
Kułakowska	nazwisko
Kułakowski	nazwisko
Kuśmierek	nazwisko
Kuśmierska	nazwisko
Kuśmierski	nazwisko
Kuśniewicz	nazwisko
Kuźmińska	nazwisko
Kuźmiński	nazwisko
Kwaśniewska	nazwisko
Kwaśniewski	nazwisko
Kwaśny	nazwisko
Kwiatkowska	nazwisko
Kwiatkowski	nazwisko
Kwiecień	nazwisko
Kwiecińska	nazwisko
Kwieciński	nazwisko
Kwintylian	imię
Kwiryn	imię
Kwiryna	imię
Kwolek	nazwisko
Kędzierska	nazwisko
Kędzierski	nazwisko
Kępa	nazwisko|geograficzna
Kępczyńska	nazwisko
Kępczyński	nazwisko
Kłoda	nazwisko|geograficzna
Kłos	nazwisko
Kłosińska	nazwisko
Kłosiński	nazwisko
Kłosowska	nazwisko
Kłosowski	nazwisko
Kłoszewska	nazwisko
Kłoszewski	nazwisko
LaSalle	nazwisko
Labuda	nazwisko
Lachowicz	nazwisko
Laine	nazwisko
Lam	nazwisko
Lamarck	nazwisko
Lamartine	nazwisko
Lambert	imię
Lamberta	imię
Lambsdorff	nazwisko
Lampedusa	nazwisko
Lancaster	nazwisko
Lancelot	imię
Lanckoroński	nazwisko
Landau	nazwisko
Landsbergis	nazwisko
Lange	nazwisko
Langiewicz	nazwisko
Laokoon	imię
Larkowski	nazwisko
Larousse	nazwisko
Larry	imię
Larysa	imię
Lasek	nazwisko|geograficzna
Laskowska	nazwisko
Laskowski	nazwisko
Lasota	nazwisko|imię
Laszczka	nazwisko
Lato	nazwisko
Laura	imię
Laurencja	imię
Laurencjusz	imię
Laurenty	imię
Laurentyn	imię
Laurentyna	imię
Lautrec	nazwisko
Lavoisier	nazwisko
Lawrence	nazwisko|geograficzna
Laxa	nazwisko
Lea	imię
Leander	imię
Lebiedź	nazwisko
Lebiest	nazwisko
Leblanc	nazwisko
Lec	pseudonim|nazwisko
Lech	nazwisko|imię
Lechosław	imię
Lechosława	imię
Lechoń	pseudonim|nazwisko
Leclanche	nazwisko
Leconte	nazwisko
Leczek	nazwisko
Leda	imię
Ledóchowski	nazwisko
Lee	nazwisko|marka|geograficzna
Leeuwenhoek	nazwisko
Lefebvre	nazwisko
Lehar	nazwisko
Lehr	nazwisko
Leibniz	nazwisko
Lejb	imię
Lelewel	nazwisko
Lelouch	nazwisko
Lem	nazwisko
Lemańska	nazwisko
Lemański	nazwisko
Lena	imię
Lenartowicz	nazwisko
Lenica	nazwisko
Leniek	nazwisko
Lennon	nazwisko
Leo	imię
Leodegar	imię
Leokadia	imię
Leon	imię
Leona	imię
Leonard	imię
Leonardo	imię
Leoncja	imię
Leoncjusz	imię
Leonek	imię
Leonia	imię
Leonid	imię
Leonida	imię
Leonidas	imię
Leonora	imię
Leontyna	imię
Leopard	imię
Leopold	imię
Leopoldyna	imię
Leosia	imię
Leoś	imię
Leporello	imię
Lepper	nazwisko
Lermontow	nazwisko
Lesiak	nazwisko
Lesio	imię
Lesińska	nazwisko
Lesiński	nazwisko
Lessing	nazwisko
Leszczyńska	nazwisko
Leszczyński	nazwisko
Leszek	imię
Lesław	imię
Lesława	imię
Levi	nazwisko
Lew	imię|człon nazwiska|astr.
Lewandowska	nazwisko
Lewandowski	nazwisko
Lewi	imię
Lewicka	nazwisko
Lewicki	nazwisko
Lewin	imię
Leś	nazwisko|imię
Leśmian	pseudonim|nazwisko
Leśniak	nazwisko
Leśniewska	nazwisko
Leśniewski	nazwisko
Leśnik	nazwisko|geograficzna
Leśnowolski	nazwisko
Libera	nazwisko
Liberat	imię
Liberata	imię
Liberiusz	imię
Libert	imię
Liboriusz	imię
Libusza	imię|geograficzna
Lichtenberg	nazwisko|geograficzna
Lideczka	imię
Lidia	imię
Lidka	imię
Lidzia	imię
Ligia	imię
Ligęza	nazwisko
Ligęzka	nazwisko
Lilia	imię
Lilian	imię
Liliana	imię
Lilianna	imię
Lilka	imię
Lilla	imię
Lilpop	nazwisko
Lima	imię|geograficzna
Limanowska	nazwisko
Limanowski	nazwisko
Lincoln	nazwisko
Linda	nazwisko
Linde	nazwisko
Lindgren	nazwisko
Lindsay	imię
Linneusz	nazwisko
Lipecki	nazwisko
Lipiec	nazwisko
Lipińska	nazwisko
Lipiński	nazwisko
Lipniak	nazwisko|geograficzna
Lipska	nazwisko
Lipski	nazwisko
Lis	nazwisko
Lisa	imię
Lisiecka	nazwisko
Lisiecki	nazwisko
Lisle	nazwisko
Lisowski	nazwisko
Listwan	nazwisko
Liszewska	nazwisko
Liszewski	nazwisko
Liszt	nazwisko
Litman	imię
Lityńska	nazwisko
Lityński	nazwisko
Livingstone	nazwisko
Liw	nazwisko|geograficzna
Liwia	imię
Liwiusz	imię
Liza	imię
Llosa	nazwisko
Lloyd	nazwisko
Locci	nazwisko
Locke	nazwisko
Loda	imię
Lodzia	imię
Lofton	nazwisko
Lojzeczek	imię
Lojzek	imię
Lojzik	imię
Lolek	imię
Lolita	imię
Lolo	imię
Lombroso	nazwisko
Lonczak	nazwisko
London	nazwisko
Lonek	imię
Longfellow	nazwisko
Longin	imię
Longina	imię
Longinus	imię
Lonia	imię
Lope	imię
Lora	imię
Lorca	nazwisko
Loren	pseudonim|nazwisko
Lorentz	nazwisko
Loretta	imię
Losey	nazwisko
Lot	imię
Louis	imię
Luba	imię
Lubecki	nazwisko
Lubera	nazwisko
Lubogost	imię
Lubomir	imię
Lubomira	imię
Lubomirska	nazwisko
Lubomirski	nazwisko
Lubomysł	imię
Lubor	imię
Lubosz	nazwisko|geograficzna
Lubosza	imię
Lubosław	imię
Lucek	imię
Lucia	imię
Lucio	imię
Lucja	imię
Lucjan	imię
Lucjola	imię
Lucjusz	imię
Lucuś	imię
Lucyfer	imię
Lucylian	imię
Lucylla	imię
Lucyna	imię
Lucyper	imię
Ludeczek	imię
Ludeczka	imię
Ludek	imię
Ludgarda	imię
Ludka	imię
Ludlum	nazwisko
Ludmiła	imię
Ludomir	imię
Ludomira	imię
Ludomił	imię
Ludomiła	imię
Ludosław	imię
Ludvig	imię
Ludwiczek	imię
Ludwig	imię
Ludwik	imię
Ludwika	imię
Ludwina	imię
Ludwinia	imię
Ludwinka	imię
Ludwisia	imię
Ludwiś	imię
Ludwiżanka	nazwisko
Luiza	imię
Lukrecja	imię
Lukrecjusz	imię
Lukullus	imię
Lukács	nazwisko
Lumiere	nazwisko
Lundegårdh	nazwisko
Lupus	imię
Lusia	imię
Lussac	nazwisko
Lutek	imię
Luter	nazwisko
Luther	nazwisko
Lutobor	imię
Lutogniew	imię
Lutomir	imię
Lutomysł	imię
Lutosław	imię
Lutosławska	nazwisko
Lutosławski	nazwisko
Lutz	nazwisko
Luśka	imię
Lynch	nazwisko
Lęcznarowicz	nazwisko
MacArthur	nazwisko
MacCarthy	nazwisko
MacDonald	nazwisko
Macaulay	nazwisko
Macedoniusz	imię
Machabeusz	imię
Machalica	nazwisko
Macharski	nazwisko
Machek	nazwisko
Machiavelli	nazwisko
Machna	nazwisko
Machowska	nazwisko
Machowski	nazwisko
Maciej	imię
Maciejewska	nazwisko
Maciejewski	nazwisko
Maciek	imię
Macierewicz	nazwisko
Maciesza	nazwisko
Maciosek	nazwisko
Maciusiak	nazwisko
Maciuś	imię
Maciąg	nazwisko
Mackiewicz	nazwisko
Maclean	nazwisko
Macpherson	nazwisko
Macquarie	nazwisko|geograficzna
Maczek	nazwisko
Madalińska	nazwisko
Madaliński	nazwisko
Madej	nazwisko
Madejska	nazwisko
Madejski	nazwisko
Madison	nazwisko
Madonna	imię
Madura	nazwisko|geograficzna
Maduzia	nazwisko
Madzia	imię
Maeterlinck	nazwisko
Magda	imię
Magdalena	imię
Magdalenka	imię|geograficzna
Magdusia	imię
Magdzia	imię
Magellan	nazwisko
Magierska	nazwisko
Magierski	nazwisko
Maginot	nazwisko
Magnus	imię
Magritte	nazwisko
Magryn	imię
Mahler	nazwisko
Mahomet	imię
Mailer	nazwisko
Maj	nazwisko
Maja	imię
Majakowska	nazwisko
Majakowski	nazwisko
Majcher	nazwisko
Majchrzak	nazwisko
Majerczak	nazwisko
Majewska	nazwisko
Majewski	nazwisko
Majka	imię
Majkowska	nazwisko
Majkowski	nazwisko
Makarenko	nazwisko
Makary	imię
Maklakiewicz	nazwisko
Makowiecka	nazwisko
Makowiecki	nazwisko
Makowska	nazwisko
Makowski	nazwisko
Makryna	imię
Maks	imię
Makselon	nazwisko
Maksio	imię
Maksym	imię
Maksymek	imię
Maksymilian	imię
Maksymiuk	nazwisko
Makula	nazwisko
Makulska	nazwisko
Makulski	nazwisko
Makuszyńska	nazwisko
Makuszyński	nazwisko
Malachiasz	imię
Malacina	nazwisko
Malaparte	pseudonim|nazwisko
Malasiński	nazwisko
Malczewska	nazwisko
Malczewski	nazwisko
Malcówna	nazwisko
Maldini	nazwisko
Malec	nazwisko
Malewska	nazwisko
Malewski	nazwisko
Malicka	nazwisko
Malicki	nazwisko
Malina	imię
Malinowska	nazwisko
Malinowski	nazwisko
Maliszewska	nazwisko
Maliszewski	nazwisko
Malińska	nazwisko
Maliński	nazwisko
Mallarme	nazwisko
Malraux	nazwisko
Malthus	nazwisko
Malwin	imię
Malwina	imię
Malwinka	imię
Mamczur	nazwisko
Mamert	imię
Mandela	nazwisko
Mandelsztam	nazwisko
Manet	nazwisko
Manfred	imię
Manfreda	imię
Mania	imię
Maniek	imię
Maniusia	imię
Maniuś	imię
Mann	nazwisko
Mansart	nazwisko
Manson	nazwisko
Manswet	imię
Mantegna	nazwisko
Manteuffel	nazwisko
Manuel	imię
Manuela	imię
Mao	nazwisko
Marasek	nazwisko
Marat	nazwisko
Marc	imię
Marcel	imię
Marcela	imię
Marceli	imię
Marcelin	imię
Marcelina	imię
Marcelka	imię
Marchais	nazwisko
Marchołt	imię
Marcia	imię
Marcian	imię
Marcin	imię
Marcinek	imię
Marciniak	nazwisko
Marcinkiewicz	nazwisko
Marcinkowska	nazwisko
Marcinkowski	nazwisko
Marcjal	imię
Marcjan	imię
Marcjanna	imię
Marco	imię
Marconi	nazwisko
Marcuse	nazwisko
Marcysia	imię
Marcyś	imię
Marczak	nazwisko
Marczewska	nazwisko
Marczewski	nazwisko
Marduk	imię
Marduła	nazwisko
Mareczek	imię
Marek	nazwisko|imię
Margaret	imię
Maria	imię
Marian	imię
Marianek	imię
Marianna	imię
Marianowska	nazwisko
Marika	imię
Marina	imię
Mariola	imię
Mariolcia	imię
Mariolka	imię
Marion	nazwisko|imię
Maritain	nazwisko
Mariusz	imię
Mariuszek	imię
Marivaux	nazwisko
Markiewicz	nazwisko
Markowicz	nazwisko
Markowska	nazwisko
Markowski	nazwisko
Marks	nazwisko
Markuszewska	nazwisko
Markuszewski	nazwisko
Marlena	imię
Marlowe	nazwisko
Marquez	nazwisko
Marr	nazwisko
Mars	imię|astr.
Marshall	nazwisko
Marszałek	nazwisko
Marta	imię
Marteczka	imię
Martin	nazwisko
Martunia	imię
Martusia	imię
Martuszewski	nazwisko
Martyn	imię
Martyna	imię
Martynian	imię
Martyriusz	imię
Marusarz	nazwisko
Marusarzówna	nazwisko
Marusia	imię
Maruszewska	nazwisko
Maruszewski	nazwisko
Maruś	imię
Marychna	imię
Maryja	imię
Maryjka	imię
Maryla	imię
Marylenka	imię
Marylka	imię
Maryn	imię
Maryna	imię
Marynia	imię
Maryniarczyk	nazwisko
Marynka	imię
Marysia	imię
Marysieńka	imię
Maryś	imię
Maryśka	imię
Marzec	nazwisko
Marzena	imię
Marzenka	imię
Marzenna	imię
Masaryk	nazwisko
Masina	nazwisko
Massenet	nazwisko
Massimo	imię
Mastroianni	nazwisko
Masza	imię
Masław	imię
Masłowska	nazwisko
Masłowski	nazwisko
Mateja	nazwisko
Matejko	nazwisko
Materna	nazwisko|imię
Mateusz	imię
Mateuszek	imię
Mateńka	nazwisko
Matfiz	nazwisko
Matisse	nazwisko
Matkowska	nazwisko
Matkowski	nazwisko
Matrejek	nazwisko
Matron	imię
Matrona	imię
Matthaeus	nazwisko
Matusiak	nazwisko
Matuszak	nazwisko
Matuszewska	nazwisko
Matuszewski	nazwisko
Matuzal	imię
Matuzalem	imię
Matyjek	nazwisko
Matylda	imię
Matysek	imię
Matysiak	nazwisko
Maugham	nazwisko
Maupassant	nazwisko
Maura	imię
Mauriac	nazwisko
Maurois	nazwisko
Maurycy	imię
Mauryn	imię
Max	imię
Maxwell	nazwisko
May	nazwisko
Mayenowa	nazwisko
Mazarin	nazwisko
Mazepa	nazwisko
Maziarska	nazwisko
Maziarski	nazwisko
Mazowiecki	nazwisko
Mazur	nazwisko
Mazurek	nazwisko
Mazurkiewicz	nazwisko
Mazurowska	nazwisko
Mazurowski	nazwisko
Maćko	imię
Maćkowiak	nazwisko
Maćkowska	nazwisko
Maćkowski	nazwisko
Małachowska	nazwisko
Małachowski	nazwisko
Małcużyńska	nazwisko
Małcużyński	nazwisko
Małecka	nazwisko
Małecki	nazwisko
Małek	nazwisko
Małgola	imię
Małgorzata	imię
Małgorzatka	imię
Małgosia	imię
Małgośka	imię
Małka	imię
Małkow	nazwisko
Małkowska	nazwisko
Małkowski	nazwisko
Małocha	nazwisko
Mały	nazwisko
Małysz	nazwisko
Mańczak	nazwisko
Mańka	imię
Mańkowska	nazwisko
Mańkowski	nazwisko
Maśnica	nazwisko
Maźnicki	nazwisko
McCartney	nazwisko
McDonald	nazwisko
McKinley	nazwisko|geograficzna
McLuhan	nazwisko
Mech	nazwisko
Mechtylda	imię
Mecziar	nazwisko
Medard	nazwisko
Medin	nazwisko
Medwid	nazwisko
Mefisto	imię
Mefistofeles	imię
Mehoffer	nazwisko
Mehta	nazwisko
Meir	imię
Meisels	nazwisko
Meissner	nazwisko
Mela	imię
Melania	imię
Melanka	imię
Melchior	imię
Melcia	imię
Meliés	nazwisko
Melka	imię
Melpomena	imię
Memling	nazwisko
Menachem	imię
Menassa	imię
Mendel	nazwisko|imię
Mendelejew	nazwisko
Mendelssohn	nazwisko
Menelaos	imię
Menuhin	nazwisko
Mercedes	imię
Merckx	nazwisko
Mercury	nazwisko
Merecedes	imię
Merkury	imię|astr.
Merlini	nazwisko
Mermer	nazwisko
Messiaen	nazwisko
Meszaros	nazwisko
Metody	imię
Metternich	nazwisko
Meyerbeer	nazwisko
Micha	imię
Michael	imię
Michaił	imię
Michala	imię
Michalak	nazwisko
Michalczyk	nazwisko
Michalec	nazwisko
Michalik	nazwisko
Michalina	imię
Michalska	nazwisko
Michalski	nazwisko
Michasia	imię
Michał	imię
Michałek	imię
Michałkow	nazwisko
Michałowska	nazwisko
Michałowski	nazwisko
Michaś	imię
Michaśka	imię
Micheasz	imię
Michelle	imię
Michna	nazwisko
Michnik	nazwisko
Michno	nazwisko
Micińska	nazwisko
Miciński	nazwisko
Micka	imię
Mickiewicz	nazwisko
Micuda	nazwisko
Miczurin	nazwisko
Midas	imię
Miecia	imię
Mieciek	imię
Miecio	imię
Mieczkowska	nazwisko
Mieczkowski	nazwisko
Mieczysław	imię
Mieczysława	imię
Miedzińska	nazwisko
Miedziński	nazwisko
Mielcarek	nazwisko
Mielczarek	nazwisko
Mielus	nazwisko
Mieroszewska	nazwisko
Mieroszewski	nazwisko
Mierosławska	nazwisko
Mierosławski	nazwisko
Mierzejewska	nazwisko
Mierzejewski	nazwisko
Mierzwińska	nazwisko
Mierzwiński	nazwisko
Mieszko	imię
Mieszkowska	nazwisko
Mieszkowski	nazwisko
Mieteczek	imię
Mietek	imię
Mifune	nazwisko
Mijakowska	nazwisko
Miki	imię
Mikke	nazwisko
Miklosich	nazwisko
Mikosz	nazwisko
Mikołaj	imię
Mikołajczak	nazwisko
Mikołajczyk	nazwisko
Mikołajek	imię
Mikołajewska	nazwisko
Mikołajewski	nazwisko
Mikołajska	nazwisko
Mikołajski	nazwisko
Mikulenas	nazwisko
Mikulska	nazwisko
Mikulski	nazwisko
Mikuszewski	nazwisko
Mikuta	nazwisko
Mikłucho	nazwisko
Mila	imię
Milada	imię
Milan	imię
Milaniak	nazwisko
Milcia	imię
Milcjades	imię
Milczanowska	nazwisko
Milczanowski	nazwisko
Milczarek	nazwisko
Milena	imię
Milenia	imię
Milewicz	nazwisko
Milewska	nazwisko
Milewski	nazwisko
Milhaud	nazwisko
Miligost	imię
Milka	imię
Miller	nazwisko
Milne	nazwisko
Miloszević	nazwisko
Milton	nazwisko
Min	nazwisko
Minelli	nazwisko
Minerwa	imię
Minh	nazwisko|geograficzna
Minkowska	nazwisko
Minkowski	nazwisko
Minodora	imię
Minos	imię
Minotaur	imię
Miodek	nazwisko
Miodowicz	nazwisko
Mioduszewska	nazwisko
Mioduszewski	nazwisko
Mira	imię
Mirabeau	nazwisko
Miranda	imię
Mireczek	imię
Mireczka	imię
Mirek	imię
Mirella	imię
Miriam	imię
Mirisława	imię
Mirka	imię
Mirogniew	imię
Miron	imię
Mironieg	imię
Mironiega	imię
Mirosław	imię
Mirosława	imię
Mirusia	imię
Miruś	imię
Misia	imię
Misiak	nazwisko
Misiek	imię
Mistarz	nazwisko
Misza	imię
Misztek	nazwisko
Mitchell	nazwisko
Mitchum	nazwisko
Mitterand	nazwisko
Mitterrand	nazwisko
Mizerska	nazwisko
Mizerski	nazwisko
Mizioł	nazwisko
Mićka	imię
Międzyrzecka	nazwisko
Międzyrzecki	nazwisko
Miętta	nazwisko
Miłogost	imię
Miłorad	imię
Miłosz	nazwisko|imię
Miłoszewska	nazwisko
Miłoszewski	nazwisko
Miłosław	imię|geograficzna
Miłosława	imię
Miłowan	imię
Miłowit	imię
Miś	imię
Miśka	imię
Miśkiewicz	nazwisko
Mleczko	nazwisko
Mlostek	nazwisko
Mnemosyne	imię
Mniszech	nazwisko
Mniszkówna	nazwisko
Mobutu	nazwisko
Mochnacka	nazwisko
Mochnacki	nazwisko
Moczar	nazwisko
Moczarska	nazwisko
Moczarski	nazwisko
Moczulska	nazwisko
Moczulski	nazwisko
Moczydłowska	nazwisko
Moczydłowski	nazwisko
Modest	imię
Modesta	imię
Modigliani	nazwisko
Modrzejewska	nazwisko
Modrzejewski	nazwisko
Modrzewska	nazwisko
Modrzewski	nazwisko
Modzelewska	nazwisko
Modzelewski	nazwisko
Mohamed	imię
Mohammed	imię
Mojmir	imię
Mojsze	imię
Mojżesz	imię
Mokij	imię
Molczyk	nazwisko
Molenda	nazwisko
Molier	nazwisko
Moliére	nazwisko
Molnar	nazwisko
Moloch	imię
Molska	nazwisko
Molski	nazwisko
Monatowa	nazwisko
Monet	nazwisko
Monia	imię
Moniczka	imię
Monika	imię
Monisia	imię
Moniuszko	nazwisko
Monroe	nazwisko
Montaigne	nazwisko
Montand	nazwisko
Montelupi	nazwisko
Monteskiusz	nazwisko
Montesquieu	nazwisko
Montgomery	nazwisko|geograficzna
Montsko	nazwisko
Moore	nazwisko
Moravia	pseudonim|nazwisko
Morawska	nazwisko
Morawski	nazwisko
Morcinek	nazwisko
Mordan	nazwisko
Mordechaj	imię
Morfeusz	imię
Morgan	nazwisko
Morientes	nazwisko
Morricone	nazwisko
Morse	nazwisko
Morstinowa	nazwisko
Morsztyn	nazwisko
Mortkowicz	nazwisko
Moryc	imię
Morzysław	imię
Mosiek	imię
Mossakowska	nazwisko
Mossakowski	nazwisko
Mostowicz	nazwisko
Mostowska	nazwisko
Mostowski	nazwisko
Moszczyńska	nazwisko
Moszczyński	nazwisko
Mountbatten	nazwisko
Mourning	nazwisko
Moyseowicz	nazwisko
Mozart	nazwisko
Mołotow	nazwisko
Mościcka	nazwisko
Mościcki	nazwisko
Możdżyńska	nazwisko
Możdżyński	nazwisko
Mracielnik	nazwisko
Mroczkowska	nazwisko
Mroczkowski	nazwisko
Mroszczyk	nazwisko
Mrowińska	nazwisko
Mrowiński	nazwisko
Mrozińska	nazwisko
Mroziński	nazwisko
Mrozowska	nazwisko
Mrozowski	nazwisko
Mrożek	nazwisko
Mrówczyńska	nazwisko
Mrówczyński	nazwisko
Mubarak	nazwisko
Mucha	nazwisko
Mundek	imię
Mundzik	imię
Mundzio	imię
Munk	nazwisko
Munthe	nazwisko
Murawska	nazwisko
Murawski	nazwisko
Murańka	nazwisko
Murdza	nazwisko
Murias	nazwisko
Murillo	nazwisko
Muryjas	nazwisko
Musiał	nazwisko
Muskat	nazwisko
Muskie	nazwisko
Musset	nazwisko
Mussolini	nazwisko
Mussorgski	nazwisko
Muszyński	nazwisko
Mutombo	nazwisko
Mylibor	imię
Myślewski	nazwisko
Myślibor	imię
Myślimir	imię
Myślińska	nazwisko
Myśliński	nazwisko
Mérimée	nazwisko
Mączyńska	nazwisko
Mączyński	nazwisko
Mądry	nazwisko
Męcimir	imię
Mężydło	nazwisko
Młodawska	nazwisko
Młodawski	nazwisko
Młotkowska	nazwisko
Młotkowski	nazwisko
Młynarczyk	nazwisko
Młynek	nazwisko|geograficzna
Mścibor	imię
Mścigniew	imię
Mścisław	imię
Mścisława	imię
Mściwoj	imię
Mściwój	imię
Nabokow	nazwisko
Nabuchodonozor	imię
Nachman	imię
Naczesław	imię
Nadab	imię
Nadbor	imię
Nadia	imię
Nadieżda	imię
Nadmir	imię
Nadolska	nazwisko
Nadolski	nazwisko
Nadzia	imię
Nadzieja	imię
Naftali	imię
Nagy	nazwisko
Nahum	imię
Naipaul	nazwisko
Namysław	imię
Namysłowska	nazwisko
Namysłowski	nazwisko
Nancy	imię|geograficzna
Nansen	nazwisko
Napierska	nazwisko
Napierski	nazwisko
Napiórkowska	nazwisko
Napiórkowski	nazwisko
Napoleon	imię
Narbut	imię
Narbutt	nazwisko
Narcyz	imię
Narcyza	imię
Naruszewicz	nazwisko
Narutowicz	nazwisko
Nastek	imię
Nastka	imię
Nastusia	imię
Nastuś	imię
Nata	imię
Natalia	imię
Natalis	imię
Natalka	imię
Natan	imię
Natanael	imię
Natanson	nazwisko
Natasza	imię
Naum	imię
Nauma	imię
Nauzyka	imię
Nauzykaa	imię
Nawoj	imię
Nawrocka	nazwisko
Nawrocki	nazwisko
Nawrot	nazwisko
Nawrót	nazwisko
Nałkowska	nazwisko
Nałkowski	nazwisko
Neferetiti	imię
Nefretete	imię
Nehemiasz	imię
Nehru	nazwisko
Nelly	imię
Nelson	nazwisko|imię
Nemcova	nazwisko
Nemeth	nazwisko
Nemezis	imię
Nemezjusz	imię
Nemezys	imię
Neonila	imię
Nepomucen	imię
Neptun	imię|astr.
Neron	imię
Neruda	nazwisko
Nestor	imię
Neszka	imię
Netaniahu	nazwisko
Newerly	nazwisko
Newman	nazwisko
Newton	nazwisko
Nicefor	imię
Niecisław	imię
Nieckarz	nazwisko
Niedamir	imię
Niedzielska	nazwisko
Niedzielski	nazwisko
Niedźwiecka	nazwisko
Niedźwiecki	nazwisko
Niegomir	imię
Niegosław	imię
Niegosława	imię
Niekrasow	nazwisko
Niemcewicz	nazwisko
Niemczura	nazwisko
Niemczyk	nazwisko
Niemeyer	nazwisko
Niemiec	nazwisko
Niemir	imię
Niemira	imię
Niesiołowska	nazwisko
Niesiołowski	nazwisko
Niesłuchowska	nazwisko
Niesłuchowski	nazwisko
Nietzsche	nazwisko
Niewiadomska	nazwisko
Niewiadomski	nazwisko
Niewiarowska	nazwisko
Niewiarowski	nazwisko
Niezamysł	imię
Nieznamir	imię
Nightingale	nazwisko
Nik	imię
Nika	imię
Nikanor	imię
Nike	imię
Nikita	imię
Nikodem	imię
Nikon	imię
Nikołaj	imię
Nikoś	imię
Nikuś	imię
Nil	nazwisko|krój pisma|imię|geograficzna
Nimfa	imię
Nina	imię
Nineczka	imię
Ninka	imię
Ninogniew	imię
Ninomysł	imię
Niobe	imię
Niro	nazwisko
Nitsch	nazwisko
Nixon	nazwisko
Nizioł	nazwisko
Niziurski	nazwisko
Niżyński	nazwisko
Noakowska	nazwisko
Noakowski	nazwisko
Nobel	nazwisko
Noe	imię
Noemi	imię
Nonna	imię
Nora	imię
Norbercik	imię
Norbert	imię
Norberta	imię
Norblin	nazwisko
Norman	imię
Norwid	nazwisko
Nosisław	imię
Nosowska	nazwisko
Nosowski	nazwisko
Nowacka	nazwisko
Nowacki	nazwisko
Nowaczyk	nazwisko
Nowaczyńska	nazwisko
Nowaczyński	nazwisko
Nowak	nazwisko
Nowakowa	nazwisko
Nowakowska	nazwisko
Nowakowski	nazwisko
Nowicka	nazwisko
Nowicki	nazwisko
Nowina	nazwisko
Nowińska	nazwisko
Nowiński	nazwisko
Nowodworski	nazwisko
Nowosielska	nazwisko
Nowosielski	nazwisko
Nowosilcow	nazwisko
Nowotka	nazwisko
Nowotko	nazwisko
Nowowiejska	nazwisko
Nowowiejski	nazwisko
Nufcio	imię
Nullo	nazwisko
Nurzyńska	nazwisko
Nurzyński	nazwisko
Nysan	imię
Nędza	nazwisko
Obara	nazwisko
Obiała	nazwisko
Obrazcow	nazwisko
Obrębska	nazwisko
Obrębski	nazwisko
Ochab	nazwisko
Ochman	nazwisko
Ochocińska	nazwisko
Ochociński	nazwisko
Ochojska	nazwisko
Ochojski	nazwisko
Ociepka	nazwisko
Ocio	imię
Ockham	nazwisko
Oda	imię
Odil	imię
Odilla	imię
Odlanicki	nazwisko
Odo	imię
Odon	imię
Odrowąż	nazwisko
Odyn	imię
Odyniec	nazwisko
Odynokow	nazwisko
Odys	imię
Odyseusz	imię
Oersted	nazwisko
Ofelia	imię
Offenbach	nazwisko
Ogińska	nazwisko
Ogiński	nazwisko
Ogonowska	nazwisko
Ogonowski	nazwisko
Ohm	nazwisko
Ojstrach	nazwisko
Okołów	nazwisko
Okońska	nazwisko
Okoński	nazwisko
Okrzeja	nazwisko
Okręglak	nazwisko
Oksiuta	nazwisko
Oktawia	imię
Oktawian	imię
Oktawianek	imię
Oktawiusz	imię
Oktawiuszek	imię
Okudżawa	nazwisko
Okulicki	nazwisko
Ola	imię
Olaf	imię
Olbracht	imię
Olbrychska	nazwisko
Olbrychski	nazwisko
Olczak	nazwisko
Olczyk	nazwisko
Olech	imię
Olechowska	nazwisko
Olechowski	nazwisko
Oleczek	imię
Oleg	imię
Olejniczak	nazwisko
Olejnik	nazwisko
Olek	imię
Oleksy	nazwisko
Olesińska	nazwisko
Olesiński	nazwisko
Olesza	nazwisko
Oleńka	imię
Oleś	imię
Oleśnicka	nazwisko
Oleśnicki	nazwisko
Olga	imię
Olgierd	imię
Olgierdek	imię
Olgierdzik	imię
Olimpia	imię
Olimpiusz	imię
Olisadebe	nazwisko
Oliver	imię
Olivia	imię
Olivier	imię
Oliwer	imię
Oliwia	imię
Oliwier	imię
Olkowska	nazwisko
Olkowski	nazwisko
Olszanicki	nazwisko
Olszańska	nazwisko
Olszański	nazwisko
Olszewska	nazwisko
Olszewski	nazwisko
Olszowa	nazwisko|geograficzna
Olunia	imię
Oluś	imię
Onassis	nazwisko
Ondraszek	imię
Onezjusz	imię
Onufry	imię
Onyszkiewicz	nazwisko
Opalińska	nazwisko
Opaliński	nazwisko
Oppenheimer	nazwisko
Oppman	nazwisko
Opyrchał	nazwisko
Ordonówna	nazwisko
Orest	imię
Orestes	imię
Orfeusz	imię
Orff	nazwisko
Orion	imię|astr.
Orkan	nazwisko
Orlikowska	nazwisko
Orlikowski	nazwisko
Orlińska	nazwisko
Orliński	nazwisko
Ormandy	nazwisko
Orszagh	nazwisko
Orwell	nazwisko
Orzechowska	nazwisko
Orzechowski	nazwisko
Orzeszkowa	nazwisko
Orzeł	nazwisko
Orłowa	nazwisko
Orłowski	nazwisko
Oscar	własna|imię
Osetek	nazwisko
Osfald	imię
Osiatyńska	nazwisko
Osiatyński	nazwisko
Osiecka	nazwisko
Osiecki	nazwisko
Osip	imię
Osiński	nazwisko
Osjan	imię
Oskar	imię
Osnowski	nazwisko
Osowska	nazwisko
Osowski	nazwisko
Ossietzky	nazwisko
Ossolińska	nazwisko
Ossoliński	nazwisko
Ossowska	nazwisko
Ossowski	nazwisko
Ostafin	nazwisko
Ostap	imię
Osterwa	nazwisko
Osterwina	nazwisko
Ostrowska	nazwisko
Ostrowski	nazwisko
Oswald	nazwisko|imię
Oswalda	imię
Osóbka	nazwisko
Otek	imię
Otello	imię
Otomar	imię
Otto	imię
Otton	imię
Otylia	imię
Otylka	imię
Owczarek	nazwisko
Owen	nazwisko
Owidiusz	imię
Owies	nazwisko
Owsiak	nazwisko
Ozeasz	imię
Oziasz	imię
Ozjasz	imię
Ozyrys	imię
Oślizło	nazwisko
O’Connell	nazwisko
O’Neill	nazwisko
Pabian	imię
Pablo	imię
Pachelbel	nazwisko
Pachulska	nazwisko
Pachulski	nazwisko
Pacino	nazwisko
Paciorkowska	nazwisko
Paciorkowski	nazwisko
Paczuska	nazwisko
Paczuski	nazwisko
Paderewska	nazwisko
Paderewski	nazwisko
Pafnucy	imię
Paganini	nazwisko
Pająk	nazwisko
Pakosz	imię
Pakosław	imię
Pakulska	nazwisko
Pakulski	nazwisko
Pakuła	nazwisko
Palikot	nazwisko
Palladio	nazwisko
Pallas	przydomek|imię
Palma	nazwisko
Palme	nazwisko
Paluch	nazwisko
Pamfił	imię
Pan	imię
Pandora	imię
Panek	nazwisko|imię
Pankiewicz	nazwisko
Pankowska	nazwisko
Pankowski	nazwisko
Pankracy	imię
Pankracyk	imię
Panofsky	nazwisko
Pantagruel	imię
Pantaleon	imię
Panufnik	nazwisko
Papandreu	nazwisko
Paplińska	nazwisko
Papliński	nazwisko
Paprocka	nazwisko
Paprocki	nazwisko
Paradowska	nazwisko
Paradowski	nazwisko
Paramon	imię
Parandowska	nazwisko
Parandowski	nazwisko
Parka	imię
Parkinson	nazwisko
Parkoszowic	nazwisko
Parnicka	nazwisko
Parnicki	nazwisko
Parsifal	imię
Partyka	nazwisko
Parys	imię
Pascal	nazwisko
Paschalis	imię
Pasieka	nazwisko|geograficzna
Pasolini	nazwisko
Passendorfer	nazwisko
Passent	nazwisko
Passos	nazwisko
Pasternak	nazwisko
Pasteur	nazwisko
Paszke	nazwisko
Paszkiewicz	nazwisko
Paszkowska	nazwisko
Paszkowski	nazwisko
Paterek	nazwisko|geograficzna
Patrick	imię
Patrycja	imię
Patrycjusz	imię
Patrycy	imię
Patryk	imię
Paul	imię
Paula	imię
Paulin	imię
Paulina	imię
Paulinka	imię
Paulus	imię
Pauszer	nazwisko
Pavarotti	nazwisko
Paw	nazwisko
Pawelec	nazwisko
Pawelska	nazwisko
Pawelski	nazwisko
Paweł	imię
Pawełek	imię
Pawlak	nazwisko
Pawlicka	nazwisko
Pawlicki	nazwisko
Pawlik	nazwisko|imię
Pawlikowska	nazwisko
Pawlikowski	nazwisko
Pawliszcze	nazwisko
Pawluś	imię
Pawła	imię
Pawłow	nazwisko
Pawłowska	nazwisko
Pawłowski	nazwisko
Pazdur	nazwisko
Pazio	nazwisko
Pazura	nazwisko
Pałka	nazwisko
Pańków	nazwisko
Peck	nazwisko
Pedro	imię
Pegaz	imię
Peguy	nazwisko
Pela	imię
Pelagia	imię
Pelagiusz	imię
Pelasia	imię
Pelikan	imię
Pelunia	imię
Pen	nazwisko
Penderecka	nazwisko
Penderecki	nazwisko
Perec	nazwisko
Peres	nazwisko
Perez	nazwisko
Perkowska	nazwisko
Perkowski	nazwisko
Perla	imię
Peron	nazwisko
Perrault	nazwisko
Persefona	imię
Perseusz	imię
Perugino	nazwisko
Perun	imię
Perykles	imię
Perzyńska	nazwisko
Perzyński	nazwisko
Pesa	imię
Pesach	imię
Pestalozzi	nazwisko
Peter	imię
Petlura	nazwisko
Petrarka	nazwisko
Petronela	imię
Petronelcia	imię
Petronelka	imię
Petronia	imię
Petroniusz	imię
Petöfi	nazwisko
Petőfi	nazwisko
Phillips	nazwisko
Pia	imię
Piaget	nazwisko
Piasecka	nazwisko
Piasecki	nazwisko
Piasek	nazwisko
Picasso	nazwisko
Piechocka	nazwisko
Piechocki	nazwisko
Piechowska	nazwisko
Piechowski	nazwisko
Piekarski	nazwisko
Piekarz	nazwisko
Piekutowska	nazwisko
Piekutowski	nazwisko
Pieniążek	nazwisko
Pierce	imię
Pieronek	nazwisko
Pierre	imię
Pietkiewicz	nazwisko
Pietrzak	nazwisko
Pietrzyk	nazwisko
Pietrzykowska	nazwisko
Pietrzykowski	nazwisko
Pieńkowska	nazwisko
Pieńkowski	nazwisko
Pigmalion	imię
Pigoń	nazwisko
Pijanowska	nazwisko
Pijanowski	nazwisko
Pikulska	nazwisko
Pikulski	nazwisko
Pilarska	nazwisko
Pilarski	nazwisko
Pimen	imię
Pinochet	nazwisko
Pinokio	imię
Pinter	nazwisko
Piotr	imię
Piotreczek	imię
Piotrek	imię
Piotrowicz	nazwisko
Piotrowin	nazwisko
Piotrowska	nazwisko
Piotrowski	nazwisko
Piotruś	imię
Pippi	imię
Pirandello	nazwisko
Pirrus	imię
Pisarek	nazwisko
Pisarkowa	nazwisko
Piskorska	nazwisko
Piskorski	nazwisko
Pissarro	nazwisko
Pitagoras	imię
Pius	imię
Piwowarczyk	nazwisko
Piwońska	nazwisko
Piwoński	nazwisko
Pizarro	nazwisko
Piórkowska	nazwisko
Piórkowski	nazwisko
Piątek	nazwisko
Piątkowska	nazwisko
Piątkowski	nazwisko
Piętak	nazwisko
Piłat	imię
Piłka	nazwisko|geograficzna
Piłsudska	nazwisko
Piłsudski	nazwisko
Placyd	imię
Placydia	imię
Planck	nazwisko
Plater	nazwisko
Plato	imię
Platon	imię
Plaut	nazwisko
Plechanow	nazwisko
Pliniusz	imię
Plotyn	imię
Plucińska	nazwisko
Pluciński	nazwisko
Pluta	nazwisko
Plutarch	imię
Pluton	imię|astr.
Poczobutt	nazwisko
Podgórski	nazwisko
Podhorski	nazwisko
Poe	nazwisko
Pogorzelec	nazwisko|geograficzna
Pogwizd	imię
Pokorska	nazwisko
Pokorski	nazwisko
Pol	nazwisko
Pola	imię
Polaczek	nazwisko
Polak	nazwisko
Polakowska	nazwisko
Polakowski	nazwisko
Polańczyk	nazwisko|geograficzna
Polańska	nazwisko
Polański	nazwisko
Polcia	imię
Poldek	imię
Poldka	imię
Poldzia	imię
Poldzio	imię
Polek	imię
Polewoj	nazwisko
Polgár	nazwisko
Polifem	imię
Polihymnia	imię
Polikarp	imię
Polikarpek	imię
Polikarpik	imię
Politowska	nazwisko
Politowski	nazwisko
Polkowska	nazwisko
Polkowski	nazwisko
Polluks	imię
Polo	nazwisko
Poloniusz	imię
Polonka	imię
Polunia	imię
Polusia	imię
Pomianowska	nazwisko
Pomianowski	nazwisko
Pompeja	imię
Pompejusz	imię
Pompidou	nazwisko
Poncjusz	imię
Poniatowska	nazwisko
Poniatowski	nazwisko
Popiel	imię
Popiełuszko	nazwisko
Popper	nazwisko
Popławska	nazwisko
Popławski	nazwisko
Porczyńska	nazwisko
Porczyński	nazwisko
Porenut	imię
Porewit	imię
Porfirion	imię
Porosło	nazwisko
Poręba	nazwisko|geograficzna
Posejdon	imię
Pot	nazwisko
Potebnia	nazwisko
Potiomkin	nazwisko
Potocka	nazwisko
Potocki	nazwisko
Potoczek	nazwisko|geograficzna
Poulenc	nazwisko
Powell	nazwisko
Poświatowski	nazwisko
Prakseda	imię
Prażmowski	nazwisko
Preisner	nazwisko
Presley	nazwisko
Priam	imię
Prochor	imię
Prodi	nazwisko
Prokles	imię
Prokofiew	nazwisko
Prokop	imię
Prokul	imię
Prometeusz	imię
Pronaszko	nazwisko
Prosimir	imię
Prosper	imię
Prospero	imię|astr.
Prot	imię
Protagoras	imię
Protazy	imię
Protogen	imię
Proust	nazwisko
Prozerpina	imię
Prudencjusz	imię
Prusińska	nazwisko
Prusiński	nazwisko
Pruszyńska	nazwisko
Pruszyński	nazwisko
Prymus	imię
Pryska	imię
Przecław	imię|geograficzna
Przecława	imię
Przedbor	imię
Przedpełk	imię
Przedpełska	nazwisko
Przedpełski	nazwisko
Przedsław	imię
Przedwoj	imię
Przemek	imię
Przemił	imię
Przemuś	imię
Przemysł	imię
Przemysław	imię
Przemysława	imię
Przerwa	nazwisko
Przesmycka	nazwisko
Przesmycki	nazwisko
Przeszło	nazwisko
Przewalska	nazwisko
Przewalski	nazwisko
Przewóz	imię
Przewłoka	nazwisko|geograficzna
Przybora	nazwisko
Przyborowska	nazwisko
Przyborowski	nazwisko
Przyboś	nazwisko
Przybyczest	imię
Przybygniew	imię
Przybylska	nazwisko
Przybylski	nazwisko
Przybymir	imię
Przybyrad	imię
Przybysz	nazwisko
Przybyszewska	nazwisko
Przybyszewski	nazwisko
Przybysław	imię
Przybysława	imię
Przybywoj	imię
Przybyła	nazwisko
Przypkowska	nazwisko
Przypkowski	nazwisko
Prószyńska	nazwisko
Prószyński	nazwisko
Prądzyńska	nazwisko
Prądzyński	nazwisko
Pstrowska	nazwisko
Pstrowski	nazwisko
Pszczółkowska	nazwisko
Pszczółkowski	nazwisko
Ptak	nazwisko
Ptasińska	nazwisko
Ptasiński	nazwisko
Ptaszyńska	nazwisko
Ptaszyński	nazwisko
Ptolemeusz	imię
Publiusz	imię
Puccini	nazwisko
Puchalska	nazwisko
Puchalski	nazwisko
Pudens	imię
Pudowkin	nazwisko
Pugaczow	nazwisko
Pulcheria	imię
Pulitzer	nazwisko
Pullman	nazwisko
Pupka	nazwisko
Purkyne	nazwisko
Pustelnik	nazwisko|geograficzna
Pustochin	nazwisko
Puszkin	nazwisko
Putin	nazwisko
Puttkamer	nazwisko
Puttkamerowa	nazwisko
Putysław	imię
Puzio	nazwisko
Puzyna	nazwisko
Puzynina	nazwisko
Pułaska	nazwisko
Pułaski	nazwisko
Pużak	nazwisko
Pyjas	nazwisko
Pyrrus	imię
Pyrzyńska	nazwisko
Pyrzyński	nazwisko
Pytel	nazwisko
Pytkowska	nazwisko
Pytkowski	nazwisko
Pétain	nazwisko
Półtawski	nazwisko
Pęcisław	imię
Pęcisława	imię
Pękosław	imię
Quasimodo	nazwisko
Quinn	nazwisko
Quisling	nazwisko
Rabelais	nazwisko
Rachela	imię
Rachmaninow	nazwisko
Racibor	imię
Racimir	imię
Racine	nazwisko
Racisław	imię
Raczkowska	nazwisko
Raczkowski	nazwisko
Raczyńska	nazwisko
Raczyński	nazwisko
Radecka	nazwisko
Radecki	nazwisko
Radek	imię
Radetzky	nazwisko
Radiszczew	nazwisko
Radociech	imię
Radogost	imię
Radomir	imię
Radomił	imię
Radomiła	imię
Radomysł	imię
Radost	imię
Radosław	imię
Radosława	imię
Radovan	imię
Radowit	imię
Radwańska	nazwisko
Radwański	nazwisko
Radziejewska	nazwisko
Radziejewski	nazwisko
Radzikowska	nazwisko
Radzikowski	nazwisko
Radzim	imię|geograficzna
Radzimir	imię
Radzimirska	nazwisko
Radzimirski	nazwisko
Radziszewska	nazwisko
Radziszewski	nazwisko
Radzisław	imię
Radzisława	imię
Radziwiłł	nazwisko
Radziwiłłówna	nazwisko
Radziwoj	imię
Rafael	imię
Rafaela	imię
Rafalska	nazwisko
Rafalski	nazwisko
Rafał	imię
Rafałek	imię
Rainer	imię
Raissa	imię
Raj	nazwisko|geograficzna
Rajewska	nazwisko
Rajewski	nazwisko
Rajmund	imię
Rajmunda	imię
Rajmundek	imię
Rajmundzik	imię
Rajner	imię
Rajnold	imię
Rakoczy	nazwisko
Rakowiecka	nazwisko
Rakowiecki	nazwisko
Rakowska	nazwisko
Rakowski	nazwisko
Raleigh	nazwisko
Ralf	imię
Rama	imię
Ramakrishna	imię
Rameau	nazwisko
Ramzes	imię
Rapacka	nazwisko
Rapacki	nazwisko
Rapaczyńska	nazwisko
Rapaczyński	nazwisko
Rasińska	nazwisko
Rasiński	nazwisko
Rasputin	nazwisko
Raszka	nazwisko|geograficzna
Ratajczak	nazwisko
Ratajczyk	nazwisko
Rathenau	nazwisko
Ratyńska	nazwisko
Ratyński	nazwisko
Ravel	nazwisko
Reagan	nazwisko
Rebeka	imię
Reczek	nazwisko
Redford	nazwisko
Redgrave	nazwisko
Redlińska	nazwisko
Redliński	nazwisko
Rega	imię
Regina	imię
Regulska	nazwisko
Regulski	nazwisko
Reinhold	imię
Rej	nazwisko
Rejtan	nazwisko
Reks	imię
Religa	nazwisko
Remarque	nazwisko
Rembrandt	nazwisko
Remigiusz	imię
Remiszewska	nazwisko
Remiszewski	nazwisko
Remus	imię
Rena	imię
Renat	imię
Renata	imię
Renatka	imię
Rene	imię
Renia	imię
Renoir	nazwisko
René	imię
Resnais	nazwisko
Reszczyńska	nazwisko
Reszczyński	nazwisko
Reszke	nazwisko
Reuter	nazwisko
Reymont	nazwisko
Reynolds	nazwisko
Rgieł	imię
Ribbentrop	nazwisko
Richard	imię
Richelieu	nazwisko
Ridge	imię
Riepin	nazwisko
Rijn	nazwisko
Rilke	nazwisko
Rimbaud	nazwisko
Rimska	nazwisko
Rimski	nazwisko
Rita	imię
Rittner	nazwisko
Rob	imię
Robcio	imię
Robercik	imię
Robert	imię
Roberta	imię
Roberto	imię
Roberts	nazwisko
Robespierre	nazwisko
Robin	imię
Robinson	nazwisko|imię
Robuś	imię
Roch	imię
Rocigniew	imię
Rocisław	imię
Rockefeller	nazwisko
Rodakowski	nazwisko
Roderyk	imię
Rodin	nazwisko
Rodion	imię
Rodowicz	nazwisko
Rodrigues	nazwisko|imię|geograficzna
Rodryg	imię
Rodryk	imię
Rodziewiczówna	nazwisko
Roentgen	nazwisko
Rogalska	nazwisko
Rogalski	nazwisko
Roger	imię
Rogowska	nazwisko
Rogowski	nazwisko
Rogozińska	nazwisko
Rogoziński	nazwisko
Rogulska	nazwisko
Rogulski	nazwisko
Roguska	nazwisko
Roguski	nazwisko
Rokicka	nazwisko
Rokicki	nazwisko
Roksana	imię
Rola	nazwisko
Roland	imię
Rolf	imię
Rolland	nazwisko
Roma	imię
Roman	imię
Romana	imię
Romaniuk	nazwisko
Romanow	nazwisko
Romanowska	nazwisko
Romanowski	nazwisko
Romaszewska	nazwisko
Romaszewski	nazwisko
Romcio	imię
Romeczek	imię
Romek	imię
Romeo	imię
Romer	nazwisko
Romuald	imię
Romualda	imię
Romulus	imię
Romuś	imię
Ronald	imię
Ronaldo	nazwisko
Ronia	imię
Ronsard	nazwisko
Roosevelt	nazwisko
Ropelewska	nazwisko
Ropelewski	nazwisko
Rosenberg	nazwisko
Rosiak	nazwisko
Rosiewicz	nazwisko
Rosińska	nazwisko
Rosiński	nazwisko
Rossini	nazwisko
Rostisław	imię
Rostkowska	nazwisko
Rostkowski	nazwisko
Rostworowska	nazwisko
Rostworowski	nazwisko
Roszak	nazwisko
Roszkowska	nazwisko
Roszkowski	nazwisko
Rosół	nazwisko
Rosłan	imię
Roth	nazwisko
Rothschild	nazwisko
Rotschild	nazwisko
Rouget	nazwisko
Rousseau	nazwisko
Rowecka	nazwisko
Rowecki	nazwisko
Rowińska	nazwisko
Rowiński	nazwisko
Rowling	nazwisko
Rozalia	imię
Rozalka	imię
Rozwadowski	nazwisko
Rozyna	imię
Rozłucka	nazwisko
Rozłucki	nazwisko
Rościgniew	imię
Rościmir	imię
Rościsław	imię
Rościsława	imię
Roża	imię
Ruben	imię
Rubens	nazwisko
Rubinstein	nazwisko
Rublow	nazwisko
Rucińska	nazwisko
Ruciński	nazwisko
Rudek	imię
Rudkowska	nazwisko
Rudkowski	nazwisko
Rudnicka	nazwisko
Rudnicki	nazwisko
Rudnik	nazwisko|geograficzna
Rudolf	imię
Rudolfa	imię
Rudolfina	imię
Rudowska	nazwisko
Rudowski	nazwisko
Rudzio	imię
Rudzińska	nazwisko
Rudziński	nazwisko
Rufin	imię
Rufina	imię
Rufus	imię
Rujewit	imię
Rumcajs	imię
Rumińska	nazwisko
Rumiński	nazwisko
Rupert	imię
Ruprecht	imię
Rurka	nazwisko|geograficzna
Ruryk	imię
Rushdie	nazwisko
Rusnak	nazwisko
Russell	nazwisko
Russo	nazwisko
Ruszkowska	nazwisko
Ruszkowski	nazwisko
Rusłan	imię
Rut	imię
Ruta	imię
Rutherford	nazwisko
Rutka	imię
Rutkiewicz	nazwisko
Rutkowska	nazwisko
Rutkowski	nazwisko
Rybak	nazwisko
Rybarczyk	nazwisko
Rybczyńska	nazwisko
Rybczyński	nazwisko
Rybicka	nazwisko
Rybicki	nazwisko
Rybińska	nazwisko
Rybiński	nazwisko
Rychlewska	nazwisko
Rychlewski	nazwisko
Rydz	nazwisko
Ryfka	imię
Rygobert	imię
Rykowska	nazwisko
Rykowski	nazwisko
Rylejew	nazwisko
Rylska	nazwisko
Rylski	nazwisko
Rymarczyk	nazwisko
Rymkiewicz	nazwisko
Rymsza	nazwisko
Rymut	nazwisko
Rynkowska	nazwisko
Rynkowski	nazwisko
Rysia	imię
Rysiek	imię
Rysio	imię
Rysiówna	nazwisko
Ryszard	imię
Ryszarda	imię
Ryszkowska	nazwisko
Ryszkowski	nazwisko
Rywin	nazwisko
Rywka	imię
Ryś	imię
Rzecka	nazwisko
Rzecki	nazwisko
Rzeczkowska	nazwisko
Rzeczkowski	nazwisko
Rzepecka	nazwisko
Rzepecki	nazwisko
Rzepicha	imię
Rzewuska	nazwisko
Rzewuski	nazwisko
Róg	nazwisko
Rómmel	nazwisko
Rózia	imię
Róża	imię
Różańska	nazwisko
Różański	nazwisko
Różewicz	nazwisko
Różycka	nazwisko
Różycki	nazwisko
Różyczka	imię
Rębisz	nazwisko
Saba	imię
Sabacjusz	imię
Sabcia	imię
Sabin	imię
Sabina	imię
Sabinka	imię
Sacharow	nazwisko
Saddam	imię
Sade	nazwisko
Sadecka	nazwisko
Sadecki	nazwisko
Sadkowska	nazwisko
Sadkowski	nazwisko
Sadlok	nazwisko
Sadok	imię
Sadowska	nazwisko
Sadowski	nazwisko
Sadłoń	nazwisko
Safar	imię
Safo	imię
Safona	imię
Saint	nazwisko
Saint-Simon	nazwisko
Sakowska	nazwisko
Sakowski	nazwisko
Sala	imię
Salazar	nazwisko
Salcia	imię
Saldanha	nazwisko
Saletnik	nazwisko
Salezy	imię
Salinger	nazwisko
Salka	imię
Salman	imię
Salmon	imię
Salome	imię
Salomea	imię
Salomon	imię
Saloni	nazwisko
Salusia	imię
Salustiusz	imię
Salwator	imię|geograficzna
Salwin	imię
Salwiusz	imię
Sam	imię
Samaranch	nazwisko
Sambor	nazwisko|imię|geograficzna
Samborska	nazwisko
Samborski	nazwisko
Samek	imię
Samiusz	imię
Samon	imię
Samołyk	nazwisko
Sampras	nazwisko
Samson	imię
Samuel	imię
Samuela	imię
Samuelek	imię
Sandauer	nazwisko
Sandra	imię
Sanguszko	nazwisko
Sankowska	nazwisko
Sankowski	nazwisko
Santi	nazwisko
Santiago	imię|geograficzna
Sapieha	nazwisko
Sapieżanka	nazwisko
Sapieżyna	nazwisko
Sapir	nazwisko
Sapińska	nazwisko
Sapiński	nazwisko
Sapkowski	nazwisko
Sara	imię
Saramago	nazwisko
Sarandon	nazwisko
Sarbiewski	nazwisko
Sarnat	nazwisko
Sarnowska	nazwisko
Sarnowski	nazwisko
Saroyan	nazwisko
Sartre	nazwisko
Sasuła	nazwisko
Sasza	imię
Saturn	imię|astr.
Saturnin	imię
Saturnina	imię
Saul	imię
Saura	nazwisko
Saussure	nazwisko
Savonarola	nazwisko
Sawa	imię
Sawicka	nazwisko
Sawicki	nazwisko
Sawin	imię
Sawuła	nazwisko
Sałacińska	nazwisko
Sałaciński	nazwisko
Saługa	nazwisko
Scarlatti	nazwisko
Schaeffer	nazwisko
Schiller	nazwisko
Schindler	nazwisko
Schmid	nazwisko
Schmidt	nazwisko
Schmitt	nazwisko
Schneider	nazwisko
Scholastyka	imię
Scholes	nazwisko
Schopenhauer	nazwisko
Schroeder	nazwisko
Schubert	nazwisko
Schulz	nazwisko
Schumacher	nazwisko
Schumann	nazwisko
Schuster	nazwisko
Schwarz	nazwisko
Schwarzenegger	nazwisko
Scorsese	nazwisko
Scorupco	nazwisko
Scott	nazwisko
Screen	nazwisko
Scylla	imię
Scypion	imię
Searle	nazwisko
Sebald	imię
Sebastian	imię
Sebastiana	imię
Secemski	nazwisko
Seidler	nazwisko
Seklucjan	nazwisko
Sekuła	nazwisko
Selim	imię
Selma	imię
Selye	nazwisko
Sem	imię
Semenczenko	nazwisko
Semiramida	imię
Semper	nazwisko
Sen	nazwisko|imię
Sendorek	nazwisko
Seneka	nazwisko
Seniuk	nazwisko
Sepioł	nazwisko
Serafin	imię
Serafina	imię
Serapion	imię
Sergiusz	imię
Seroczyńska	nazwisko
Seroczyński	nazwisko
Serwacy	imię
Sewer	imię
Sewera	imię
Sewerian	imię
Seweryn	nazwisko|imię
Seweryna	imię
Seymour	nazwisko
Sforza	nazwisko
Shakespeare	nazwisko
Shaw	nazwisko
Shearer	nazwisko
Shelley	nazwisko|imię
Sherlock	imię
Siatkowska	nazwisko
Siatkowski	nazwisko
Sibelius	nazwisko
Sica	nazwisko
Sidorenko	nazwisko
Sieciech	imię
Sieciesław	imię
Sieciesława	imię
Siedlecki	nazwisko
Siekierska	nazwisko
Siekierski	nazwisko
Sielańczyk	nazwisko
Siemaszko	nazwisko
Siemens	nazwisko
Siemianowska	nazwisko
Siemianowski	nazwisko
Siemiodrog	imię
Siemirad	imię
Siemiradzka	nazwisko
Siemiradzki	nazwisko
Siemisław	imię
Siemińska	nazwisko
Siemiński	nazwisko
Siemomysł	imię
Siemowit	imię
Sienkiewicz	nazwisko
Sierakowska	nazwisko
Sierakowski	nazwisko
Siergiej	imię
Sieroszewska	nazwisko
Sieroszewski	nazwisko
Sierosław	imię
Sierosława	imię
Sierpińska	nazwisko
Sierpiński	nazwisko
Sierżęga	nazwisko
Siestrzemił	imię
Siestrzewit	imię
Sikora	nazwisko
Sikorska	nazwisko
Sikorski	nazwisko
Simargł	imię
Simenon	nazwisko
Simon	imię
Simona	imię
Simpson	nazwisko
Sinatra	nazwisko
Singer	nazwisko
Sisley	nazwisko
Siwek	nazwisko
Siwiec	nazwisko
Siwińska	nazwisko
Siwiński	nazwisko
Skalska	nazwisko
Skalski	nazwisko
Skarbimierz	imię|geograficzna
Skarbimir	imię
Skarga	nazwisko
Skarżanka	nazwisko
Skarżyńska	nazwisko
Skarżyński	nazwisko
Skawiańczyk	nazwisko
Skawski	nazwisko
Skała	nazwisko|geograficzna
Skiba	nazwisko
Skibińska	nazwisko
Skibiński	nazwisko
Skibniewska	nazwisko
Skibniewski	nazwisko
Skiepko	nazwisko
Skoczyk	nazwisko
Skoczyńska	nazwisko
Skoczyński	nazwisko
Skolimowska	nazwisko
Skolimowski	nazwisko
Skorecki	nazwisko
Skorulski	nazwisko
Skorupska	nazwisko
Skorupski	nazwisko
Skowron	nazwisko
Skowronek	nazwisko
Skowrońska	nazwisko
Skowroński	nazwisko
Skrzynecka	nazwisko
Skrzynecki	nazwisko
Skrzypczak	nazwisko
Skrzyńska	nazwisko
Skrzyński	nazwisko
Skubalanka	nazwisko
Skubiszewska	nazwisko
Skubiszewski	nazwisko
Skupień	nazwisko
Składkowska	nazwisko
Składkowski	nazwisko
Skłodowska	nazwisko
Skłodowski	nazwisko
Slobodan	imię
Smardzewska	nazwisko
Smardzewski	nazwisko
Smendzianka	nazwisko
Smetana	nazwisko
Smith	nazwisko
Smoczyńska	nazwisko
Smoczyński	nazwisko
Smolec	nazwisko|geograficzna
Smoleń	nazwisko|geograficzna
Smoleńska	nazwisko
Smoleński	nazwisko
Smolińska	nazwisko
Smoliński	nazwisko
Smosna	nazwisko
Smółkowa	nazwisko
Sobańska	nazwisko
Sobański	nazwisko
Sobczak	nazwisko
Sobczyk	nazwisko
Sobczyńska	nazwisko
Sobczyński	nazwisko
Sobejko	nazwisko
Sobek	imię
Sobesto	nazwisko
Sobierajska	nazwisko
Sobierajski	nazwisko
Sobieska	nazwisko
Sobieski	nazwisko
Sobiesąd	imię
Sobiesław	imię
Sobiesława	imię
Sobocińska	nazwisko
Sobociński	nazwisko
Sobota	nazwisko|geograficzna
Sobuś	imię
Soból	nazwisko
Socha	nazwisko
Sochacka	nazwisko
Sochacki	nazwisko
Socjusz	imię
Sofia	imię|geograficzna
Sofokles	imię
Sofoniasz	imię
Sofroniusz	imię
Sokalska	nazwisko
Sokalski	nazwisko
Sokołowa	nazwisko
Sokołowska	nazwisko
Sokołowski	nazwisko
Sokrat	imię
Sokrates	imię
Solange	imię
Solińska	nazwisko
Soliński	nazwisko
Solon	imię
Sonia	imię
Soplica	nazwisko
Sopoćko	nazwisko
Soryusz	nazwisko
Sosińska	nazwisko
Sosiński	nazwisko
Sosnkowski	nazwisko
Sosnowska	nazwisko
Sosnowski	nazwisko
Soter	imię
Sotheby	nazwisko
Sotnicki	nazwisko
Sotwin	nazwisko
Sowa	nazwisko
Sowińska	nazwisko
Sowiński	nazwisko
Sozant	imię
Sołtysiak	nazwisko
Sołtysik	nazwisko
Sołżenicyn	nazwisko
Sońka	imię
Spartakus	imię
Spencer	nazwisko
Speranca	imię
Spiechowicz	nazwisko
Spiegel	nazwisko
Spielberg	nazwisko
Spinda	nazwisko
Spinoza	nazwisko
Spirydion	imię
Spock	nazwisko
Springer	nazwisko
Sprynca	nazwisko
Spychalska	nazwisko
Spychalski	nazwisko
Spycigniew	imię
Spycimir	imię
Spycisław	imię
Spytko	imię
Spólnik	nazwisko
Spławiński	nazwisko
Sroczyńska	nazwisko
Sroczyński	nazwisko
Sroka	nazwisko
Srul	imię
Stach	imię
Stacha	imię
Stachowiak	nazwisko
Stachowicz	nazwisko
Stachowska	nazwisko
Stachowski	nazwisko
Stachura	nazwisko
Stachurska	nazwisko
Stachurski	nazwisko
Staff	nazwisko
Stalec	nazwisko
Stanibuła	nazwisko
Stanimir	imię
Staniszewska	nazwisko
Staniszewski	nazwisko
Stanisław	imię
Stanisława	imię
Stanisławska	nazwisko
Stanisławski	nazwisko
Stankiewicz	nazwisko
Stankowska	nazwisko
Stankowski	nazwisko
Stanley	nazwisko|imię
Starczewska	nazwisko
Starczewski	nazwisko
Starowieyski	nazwisko
Starr	pseudonim|nazwisko
Starzyńska	nazwisko
Starzyński	nazwisko
Stasia	imię
Stasiak	nazwisko
Stasicki	nazwisko
Stasiek	imię
Stasio	imię
Staszak	nazwisko
Staszek	imię
Staszewska	nazwisko
Staszewski	nazwisko
Staszic	nazwisko
Staszka	imię
Staszyc	nazwisko
Stawiarska	nazwisko
Stawiarski	nazwisko
Stawicka	nazwisko
Stawicki	nazwisko
Stawińska	nazwisko
Stawiński	nazwisko
Stawska	nazwisko
Stawski	nazwisko
Stazyjka	imię
Stańczak	nazwisko
Stańczyk	nazwisko
Stański	nazwisko
Staś	imię
Stebnicki	nazwisko
Stec	nazwisko
Steel	nazwisko
Stefa	imię
Stefan	imię
Stefanek	imię
Stefania	imię
Stefaniak	nazwisko
Stefano	nazwisko|geograficzna
Stefanow	nazwisko
Stefanów	nazwisko|geograficzna
Stefańska	nazwisko
Stefański	nazwisko
Stefcia	imię
Stefcio	imię
Stefczyk	nazwisko
Stefek	imię
Stefka	imię
Stefuś	imię
Steinbeck	nazwisko
Steinhaus	nazwisko
Stella	imię
Stempowska	nazwisko
Stempowski	nazwisko
Stendhal	nazwisko
Stendhalowska	nazwisko
Stendhalowski	nazwisko
Stenia	imię
Stentor	imię
Stephenson	nazwisko
Steven	imię
Stevenson	nazwisko
Stojan	imię
Stojałowski	nazwisko
Stojewski	nazwisko
Stojgniew	imię
Stojmir	imię
Stojsław	imię
Stokowska	nazwisko
Stokowski	nazwisko
Stolarczyk	nazwisko
Stomma	nazwisko
Stone	nazwisko
Stowe	nazwisko
Stradivari	nazwisko
Stramek	nazwisko
Straton	imię
Stratonik	imię
Strauss	nazwisko
Strawiński	nazwisko
Streep	nazwisko
Streisand	nazwisko
Strojek	nazwisko
Stronisław	imię
Stronisława	imię
Strubicz	nazwisko
Strumph-Wojtkiewicz	nazwisko
Struska	nazwisko
Struski	nazwisko
Struś	nazwisko
Stryjeńska	nazwisko
Stryjeński	nazwisko
Stryjkowska	nazwisko
Stryjkowski	nazwisko
Stryjska	nazwisko
Strzeboński	nazwisko
Strzelecki	nazwisko
Strzembosz	nazwisko
Strzeżymir	imię
Strzeżysław	imię
Strzeżysława	imię
Strzeżywoj	imię
Stuart	nazwisko
Studzińska	nazwisko
Studziński	nazwisko
Stuhr	nazwisko
Stwosz	nazwisko
Styczyńska	nazwisko
Styczyński	nazwisko
Stąporski	nazwisko
Stępień	nazwisko
Stępińska	nazwisko
Stępiński	nazwisko
Stępniak	nazwisko
Stępniewska	nazwisko
Stępniewski	nazwisko
Stępowski	nazwisko
Suchecka	nazwisko
Suchecki	nazwisko
Suchocka	nazwisko
Suchocki	nazwisko
Suchodolska	nazwisko
Suchodolski	nazwisko
Sulamita	imię
Sulejman	imię
Sulibor	imię
Sulimir	imię
Sulirad	imię
Sulisław	imię
Sulisława	imię
Suliwoj	imię
Sulińska	nazwisko
Suliński	nazwisko
Sulpicjusz	imię
Sumińska	nazwisko
Sumiński	nazwisko
Sumlet	nazwisko
Surman	nazwisko
Surzyn	nazwisko
Suwada	nazwisko
Sułkowska	nazwisko
Sułkowski	nazwisko
Svitlica	nazwisko
Swantewit	imię
Swarog	imię
Swarożyc	imię
Swaróg	imię
Swedenborg	nazwisko
Swetoniusz	imię
Swiatosław	imię
Swietłana	imię
Swietłow	nazwisko
Swift	nazwisko
Swinarski	nazwisko
Swinburne	nazwisko
Swoboda	nazwisko|geograficzna
Sybilla	imię
Sydonia	imię
Sydorenko	nazwisko
Sydow	nazwisko
Sygietyński	nazwisko
Syjona	imię
Syklecja	imię
Sykstus	imię
Sylan	imię
Sylwan	imię
Sylwana	imię
Sylwek	imię
Sylweriusz	imię
Sylwery	imię
Sylwester	imię
Sylwia	imię
Sylwin	imię
Sylwiusz	imię
Sylwuś	imię
Symcha	imię
Symeon	imię
Symonides	nazwisko
Symplicjusz	imię
Syrach	imię
Syrokomla	nazwisko
Syryński	nazwisko
Syzyf	imię
Szablewska	nazwisko
Szablewski	nazwisko
Szablowski	nazwisko
Szabłowska	nazwisko
Szabłowski	nazwisko
Szacka	nazwisko
Szacki	nazwisko
Szadkowska	nazwisko
Szadkowski	nazwisko
Szaflarska	nazwisko
Szafrańska	nazwisko
Szafrański	nazwisko
Szajnocha	nazwisko
Szalapin	nazwisko
Szamałek	nazwisko
Szamborska	nazwisko
Szamborski	nazwisko
Szamir	imię
Szamotulski	nazwisko
Szaniawska	nazwisko
Szaniawski	nazwisko
Szaporów	nazwisko
Szapołowski	nazwisko
Szarama	nazwisko
Szarffenberg	nazwisko
Szarlota	imię
Szarlotta	imię
Szaron	nazwisko
Szarowski	nazwisko
Szarzyńska	nazwisko
Szarzyński	nazwisko
Szatkowska	nazwisko
Szatkowski	nazwisko
Szaweł	imię
Szałajko	nazwisko
Szałamow	nazwisko
Szałańska	nazwisko
Szałański	nazwisko
Szałęga	nazwisko
Szańkowski	nazwisko
Szczepan	imię
Szczepanek	imię
Szczepaniak	nazwisko
Szczepanik	nazwisko
Szczepanowska	nazwisko
Szczepanowski	nazwisko
Szczepańska	nazwisko
Szczepański	nazwisko
Szczepcio	imię
Szczepek	imię
Szczepko	imię
Szczepkowska	nazwisko
Szczepkowski	nazwisko
Szcześniak	nazwisko
Szczubiał	nazwisko
Szczucka	nazwisko
Szczucki	nazwisko
Szczygielska	nazwisko
Szczygielski	nazwisko
Szczygieł	nazwisko
Szczypciak	nazwisko
Szczypiorska	nazwisko
Szczypiorski	nazwisko
Szczypińska	nazwisko
Szczypiński	nazwisko
Szczęsna	imię
Szczęsny	nazwisko|imię
Szebach	imię
Szeherezada	imię
Szekspir	nazwisko
Szela	nazwisko
Szeliga	nazwisko|geograficzna
Szelągowska	nazwisko
Szelągowski	nazwisko
Szenwald	nazwisko
Szeptycki	nazwisko
Szeptyćkyj	nazwisko
Szestow	nazwisko
Szewardnadze	nazwisko
Szewczenko	nazwisko
Szewczyk	nazwisko
Szewiński	nazwisko
Szindiapin	nazwisko
Sziwa	imię
Szlachta	nazwisko|geograficzna
Szlązak	nazwisko
Szmaciak	nazwisko
Szmaja	nazwisko|imię
Szmul	nazwisko|imię
Szober	nazwisko
Szopen	nazwisko
Szopiak	nazwisko
Szostak	nazwisko
Szostakowicz	nazwisko
Szołochow	nazwisko
Szpakowicz	nazwisko
Szpakowska	nazwisko
Szpakowski	nazwisko
Szpond	nazwisko
Szpotańska	nazwisko
Szpotański	nazwisko
Szramowiat	nazwisko
Sztaudynger	nazwisko
Sztwiertnia	nazwisko
Szuch	nazwisko
Szujski	nazwisko
Szulc	nazwisko
Szumska	nazwisko
Szumski	nazwisko
Szupryczyńska	nazwisko
Szupryczyński	nazwisko
Szwajca	nazwisko
Szwejk	nazwisko
Szwieciech	imię
Szydłowski	nazwisko
Szyma	nazwisko
Szymaniak	nazwisko
Szymanowska	nazwisko
Szymanowski	nazwisko
Szymańska	nazwisko
Szymański	nazwisko
Szymborska	nazwisko
Szymborski	nazwisko
Szymczak	nazwisko
Szymczyk	nazwisko
Szymek	imię
Szymkowiak	nazwisko
Szymon	imię
Szymona	imię
Szymonowic	nazwisko
Szymuś	imię
Szynalik	nazwisko
Szynalska	nazwisko
Szypulska	nazwisko
Szypulski	nazwisko
Szyszko	nazwisko
Szyszkowska	nazwisko
Szyszkowski	nazwisko
Sądomir	imię
Sądosław	imię
Sędzimierz	imię
Sędzimir	imię
Sędzisław	imię
Sędzisława	imię
Sędziwoj	imię
Sędziwój	imię
Sęp	nazwisko
Sław	imię
Sława	imię
Sławcio	imię
Sławeczek	imię
Sławek	imię
Sławińska	nazwisko
Sławiński	nazwisko
Sławka	imię
Sławkowska	nazwisko
Sławobor	imię
Sławoj	nazwisko|imię
Sławomierz	imię
Sławomir	imię
Sławomira	imię
Sławosz	imię
Sławska	nazwisko
Sławski	nazwisko
Sławuś	imię
Słodkowska	nazwisko
Słodkowski	nazwisko
Słomczewska	nazwisko
Słomczewski	nazwisko
Słomczyńska	nazwisko
Słomczyński	nazwisko
Słonimska	nazwisko
Słonimski	nazwisko
Słowacka	nazwisko
Słowacki	nazwisko
Słowik	nazwisko
Słowikowska	nazwisko
Słowikowski	nazwisko
Słyk	nazwisko
Tacjanna	imię
Tacyt	nazwisko
Tadek	imię
Tadeusz	imię
Tadeuszek	imię
Tadzik	imię
Tadzio	imię
Tagore	nazwisko
Taha	nazwisko
Taine	nazwisko
Tajner	nazwisko
Tajster	nazwisko
Tal	imię
Tala	imię
Tales	imię
Talib	imię
Talka	imię
Talleyrand	nazwisko
Tamara	imię
Tamerlan	imię
Tanatos	imię
Tanek	imię
Tania	imię
Tanna	imię
Tantal	imię
Tarachulski	nazwisko
Tarantino	nazwisko
Taras	imię
Tarkowska	nazwisko
Tarkowski	nazwisko
Tarnolicki	nazwisko
Tarnowski	nazwisko
Tarzan	imię
Tarło	nazwisko
Tasso	nazwisko
Taszycka	nazwisko
Taszycki	nazwisko
Tatarkiewicz	nazwisko
Tate	nazwisko
Tatiana	imię
Taylor	nazwisko
Tańska	nazwisko
Tański	nazwisko
Teilhard	nazwisko
Tekieli	nazwisko
Tekla	imię
Teklunia	imię
Teklusia	imię
Telemann	nazwisko
Telesfor	imię
Telimena	imię
Temida	imię
Temistokles	imię
Tennyson	nazwisko
Teobald	imię
Teodor	imię
Teodora	imię
Teodorek	imię
Teodoryk	imię
Teodosia	imię
Teodot	imię
Teodozja	imię
Teodozjusz	imię
Teofan	imię
Teofil	imię
Teofila	imię
Teofilek	imię
Teofilka	imię
Teofrast	imię
Teognost	imię
Teokryt	imię
Teonas	imię
Teoś	imię
Terencjusz	imię
Terenia	imię
Teresa	imię
Teresia	imię
Tereska	imię
Terka	imię
Terlecka	nazwisko
Terlecki	nazwisko
Tertulian	imię
Tesia	imię
Tetmajer	nazwisko
Tetyda	imię
Tezcatlipoca	imię
Tezeusz	imię
Thackeray	nazwisko
Thatcher	nazwisko
Themerson	nazwisko
Theodorakis	nazwisko
Thomas	imię
Thomson	nazwisko
Thorvaldsen	nazwisko
Thälmann	nazwisko
Tibor	imię
Tichon	imię
Tiepolo	nazwisko
Tierieszkowa	nazwisko
Timur	imię
Tina	imię
Tintoretto	nazwisko
Tischner	nazwisko
Tishman	nazwisko
Tito	nazwisko
Tkaczyk	nazwisko
Tobiasz	imię
Todzia	imię
Toeplitz	nazwisko
Toffler	nazwisko
Togliatti	nazwisko
Tokarczuk	nazwisko
Tokarczyk	nazwisko
Tokarski	nazwisko
Tokarz	nazwisko
Tolek	imię
Toligniew	imię
Tolimir	imię
Tolisław	imię
Tolisława	imię
Tolkien	nazwisko
Tolo	imię
Tom	imię
Toma	imię
Tomana	nazwisko
Tomasz	imię
Tomaszewska	nazwisko
Tomaszewski	nazwisko
Tomcio	imię
Tomczak	nazwisko
Tomczyk	nazwisko
Tomeczek	imię
Tomeczko	nazwisko
Tomek	imię
Tomir	imię
Tomisław	imię
Tomisława	imię
Tomił	imię
Tommy	imię
Tomuś	imię
Toni	imię
Tonio	imię
Topolska	nazwisko
Topolski	nazwisko
Torpet	imię
Torricelli	nazwisko
Toscanini	nazwisko
Tosia	imię
Tosiek	imię
Towiańska	nazwisko
Towiański	nazwisko
Toynbee	nazwisko
Tołstoj	nazwisko
Tośka	imię
Tracy	nazwisko
Traczyk	nazwisko
Trajan	imię
Trapszo	nazwisko
Traugutt	nazwisko
Travolta	nazwisko
Trawińska	nazwisko
Trawiński	nazwisko
Trembecka	nazwisko
Trembecki	nazwisko
Trestka	nazwisko
Trezeguet	nazwisko
Trietiakow	nazwisko
Tristan	imię
Trocka	nazwisko
Trocki	nazwisko
Trofim	imię
Trojan	imię
Trojanowski	nazwisko
Trojnacki	nazwisko
Trubieckoj	nazwisko
Truchan	nazwisko
Truda	imię
Trudka	imię
Trudzia	imię
Truffaut	nazwisko
Truman	nazwisko
Truszczyńska	nazwisko
Truszczyński	nazwisko
Truszkowska	nazwisko
Truszkowski	nazwisko
Tryfiliusz	imię
Tryfon	imię
Trytko	nazwisko
Trzaska	nazwisko
Trzaski	nazwisko|geograficzna
Trzaskowska	nazwisko
Trzaskowski	nazwisko
Trzciński	nazwisko
Trzebimir	imię
Trzebisław	imię
Trzebisława	imię
Trzebomysł	imię
Trzebowit	imię
Trzeciak	nazwisko
Trzetrzelewska	nazwisko
Trzetrzelewski	nazwisko
Trzpis	nazwisko
Trzyna	nazwisko
Tse-tung	nazwisko
Tucydydes	imię
Tudjman	nazwisko
Tudor	nazwisko
Tukidydes	imię
Tupolew	nazwisko
Turbasa	nazwisko
Turcza	nazwisko
Turczyn	nazwisko
Turczyńska	nazwisko
Turczyński	nazwisko
Turek	nazwisko|geograficzna
Turgieniew	nazwisko
Turing	nazwisko
Turkowska	nazwisko
Turkowski	nazwisko
Turnau	nazwisko
Turner	nazwisko
Turowicz	nazwisko
Turowiczowa	nazwisko
Turowska	nazwisko
Turowski	nazwisko
Turska	nazwisko
Turski	nazwisko
Turzański	nazwisko
Tusk	nazwisko
Tutenchamon	imię
Tuwim	nazwisko
Twain	nazwisko
Twardosław	imię
Twardowska	nazwisko
Twardowski	nazwisko
Tworzymir	imię
Tworzysław	imię
Tworzysława	imię
Tyberiusz	imię
Tyblewski	nazwisko
Tyburcjusz	imię
Tyburska	nazwisko
Tyburski	nazwisko
Tychon	imię
Tycjan	imię
Tylcia	imię
Tylda	imię
Tylka	imię
Tymińska	nazwisko
Tymiński	nazwisko
Tymon	imię
Tymoteusz	imię
Tyrawa	nazwisko|geograficzna
Tyrca	imię
Tyrmand	nazwisko
Tyrs	imię
Tyszkiewicz	nazwisko
Tytus	imię
Tyzenhaus	nazwisko
Tyzenhauz	nazwisko
Tęgomir	imię
Ubald	imię
Ubu	imię
Ubysław	imię
Ujejska	nazwisko
Ujejski	nazwisko
Ula	imię
Ulatowska	nazwisko
Ulatowski	nazwisko
Ulcia	imię
Uleczka	imię
Uleńka	imię
Ulisses	imię
Ulka	imię
Ullman	nazwisko
Ulrych	imię
Ulryk	imię
Ulryka	imię
Umberto	imię
Umer	nazwisko
Undset	nazwisko
Ungler	nazwisko
Uniedrog	imię
Uniegost	imię
Uniemysł	imię
Uniewit	imię
Unimir	imię
Unisław	imię|geograficzna
Updike	nazwisko
Uranos	imię
Urban	nazwisko|imię
Urbanek	imię
Urbaniak	nazwisko
Urbanik	nazwisko
Urbanowicz	nazwisko
Urbanowska	nazwisko
Urbanowski	nazwisko
Urbańczyk	nazwisko
Urbańska	nazwisko
Urbański	nazwisko
Urbaś	imię
Uri	imię
Uriasz	imię
Uriel	imię
Ursus	imię|geograficzna
Ursyn	imię
Urszula	imię
Urszulka	imię
Utrillo	nazwisko
Uzjasz	imię
Vaclav	imię
Valéry	nazwisko
Vancouver	nazwisko|geograficzna
Vargas	nazwisko
Vasco	nazwisko
Vega	nazwisko
Velazquez	nazwisko
Venclova	nazwisko
Ventzislav	imię
Verdi	nazwisko
Verlaine	nazwisko
Vermeer	nazwisko
Vermont	nazwisko|geograficzna
Verne	nazwisko
Veronese	nazwisko
Versace	nazwisko
Vespucci	nazwisko
Vetulani	nazwisko
Vico	nazwisko
Victoria	imię
Vinci	nazwisko
Violeta	imię
Violetta	imię
Visconti	nazwisko
Vivaldi	nazwisko
Vladimir	imię
Vogel	nazwisko
Voigt	nazwisko
Volta	nazwisko
Vranitzky	nazwisko
Wacek	imię
Wachholz	nazwisko
Wachowiak	nazwisko
Wachowicz	nazwisko
Wachowska	nazwisko
Wachowski	nazwisko
Wacio	imię
Wacunio	imię
Wacuś	imię
Wacław	imię
Wacława	imię
Wacławek	imię
Wadim	imię
Wagner	nazwisko
Wajda	nazwisko
Wala	imię
Walankiewicz	nazwisko
Walczak	nazwisko
Walczyńska	nazwisko
Walczyński	nazwisko
Waldeczek	imię
Waldek	imię
Waldemar	imię
Waldheim	nazwisko
Waldorff	nazwisko
Walduś	imię
Waldzio	imię
Walek	imię
Walendziak	nazwisko
Walenty	imię
Walentyn	imię
Walentyna	imię
Walentynowicz	nazwisko
Walercia	imię
Walerek	imię
Waleria	imię
Walerian	imię
Waleriana	imię
Waleriańczyk	nazwisko
Waleriusz	imię
Walerka	imię
Walery	imię
Wales	nazwisko
Walewska	nazwisko
Walewski	nazwisko
Walezy	nazwisko
Waliszewska	nazwisko
Waliszewski	nazwisko
Walkowiak	nazwisko
Wallace	nazwisko
Wallek	nazwisko
Wallenrod	nazwisko
Walter	nazwisko|imię
Waltz	nazwisko
Walusia	imię
Waluś	imię
Wanda	imię
Wandeczka	imię
Wandusia	imię
Wandzia	imię
Warchoł	nazwisko
Warcisław	imię
Wardzyńska	nazwisko
Wardzyński	nazwisko
Warhol	nazwisko
Warner	nazwisko
Warren	nazwisko
Warska	nazwisko
Warski	nazwisko
Wartoń	nazwisko
Warwara	imię
Waryńska	nazwisko
Waryński	nazwisko
Warzycha	nazwisko
Warłam	imię
Washington	nazwisko|geograficzna
Wasiak	nazwisko
Wasielewska	nazwisko
Wasielewski	nazwisko
Wasilewska	nazwisko
Wasilewski	nazwisko
Wassermann	nazwisko
Wasyl	imię
Wasyli	imię
Waszkiewicz	nazwisko
Waszyngton	nazwisko|geograficzna
Wat	nazwisko
Watt	nazwisko
Watteau	nazwisko
Wawryk	nazwisko
Wawryka	nazwisko
Wawrzaszek	nazwisko
Wawrzek	imię
Wawrzeń	nazwisko
Wawrzuś	imię
Wawrzyniak	nazwisko
Wawrzyniec	imię
Wawrzyńczyk	nazwisko
Wayne	nazwisko
Waza	nazwisko
Wałczyk	nazwisko
Wałęsa	nazwisko
Wańczyk	nazwisko
Wańkowicz	nazwisko
Waśniewska	nazwisko
Waśniewski	nazwisko
Ważyk	nazwisko
Wcisło	nazwisko
Wdowiak	nazwisko
Wdowik	nazwisko
Weber	nazwisko
Webster	nazwisko
Wedel	nazwisko
Wega	imię
Weigel	nazwisko
Weill	nazwisko
Weinar	nazwisko
Weinsberg	nazwisko
Weiss	nazwisko
Weissflog	nazwisko
Weizsaecker	nazwisko
Wela	imię|geograficzna
Welles	nazwisko
Wellington	nazwisko
Wells	nazwisko
Wenancjusz	imię
Wenanty	imię
Wende	nazwisko
Wendelin	imię
Wenera	imię
Wenzel	nazwisko
Wera	imię
Wercia	imię
Wereszczakówna	nazwisko
Wergili	imię
Wergiliusz	imię
Werka	imię
Werner	nazwisko|imię
Wernyhora	nazwisko
Weronika	imię
Weronka	imię
Werońcia	imię
Werter	imię
Wesołowska	nazwisko
Wesołowski	nazwisko
Wespazjan	imię
Weyssenhoff	nazwisko
Wełnicki	nazwisko
Wharton	nazwisko
White	nazwisko
Whitman	nazwisko
Whitmann	nazwisko
Wiaczesław	imię
Wicek	imię
Wicher	nazwisko
Wichrowska	nazwisko
Wichrowski	nazwisko
Wicio	imię
Wicuś	imię
Widzyk	nazwisko
Wieczorek	nazwisko
Wieczorkowska	nazwisko
Wieczorkowski	nazwisko
Wielebnowska	nazwisko
Wielisław	imię
Wielisława	imię
Wielopolski	nazwisko
Wiener	nazwisko
Wieniawa	nazwisko
Wieniawski	nazwisko
Wieprzęć	nazwisko
Wiera	imię
Wiercińska	nazwisko
Wierciński	nazwisko
Wierusz	nazwisko|człon nazwiska (herb)
Wierzbicka	nazwisko
Wierzbicki	nazwisko
Wierzbowska	nazwisko
Wierzbowski	nazwisko
Wierzchosław	imię
Wierzchosława	imię
Wierzchowska	nazwisko
Wierzchowski	nazwisko
Wierzchoń	nazwisko
Wierzejska	nazwisko
Wierzejski	nazwisko
Wierzynek	nazwisko
Wierzyńska	nazwisko
Wierzyński	nazwisko
Wiesel	nazwisko
Wiesenthal	nazwisko
Wiesia	imię
Wiesiek	imię
Wiesio	imię
Wiesław	imię
Wiesława	imię
Wietecha	nazwisko
Wieńczysław	imię
Wieśka	imię
Wiganna	imię
Wigura	nazwisko
Wika	imię
Wikcia	imię
Wikiński	nazwisko
Wikta	imię
Wiktor	imię
Wiktoria	imię
Wiktorian	imię
Wiktoriusz	imię
Wiktorowska	nazwisko
Wiktorowski	nazwisko
Wiktoryn	imię
Wiktoryna	imię
Wiktusia	imię
Wilczek	nazwisko
Wilczewska	nazwisko
Wilczewski	nazwisko
Wilde	nazwisko
Wilder	nazwisko
Wilek	imię
Wilfried	imię
Wilhelm	imię
Wilhelmi	nazwisko
Wilhelmina	imię
Wiliam	imię
Wilibald	imię
Wilińska	nazwisko
Wiliński	nazwisko
Wilk	nazwisko
William	imię
Williams	nazwisko
Willy	imię
Willys	nazwisko
Wilson	nazwisko
Wiluś	imię
Wincek	imię
Wincenta	imię
Wincenty	imię
Winfrey	nazwisko
Winfried	imię
Winiarski	nazwisko
Winicjusz	imię
Winnetou	imię
Winnicka	nazwisko
Winnicki	nazwisko
Wioleta	imię
Wioletta	imię
Wirgilia	imię
Wirgiliusz	imię
Wirginia	imię|geograficzna
Wirginiusz	imię
Wirpsza	nazwisko
Wiszniewska	nazwisko
Wiszniewski	nazwisko
Wisznu	imię
Wiszyński	nazwisko
Wisław	imię
Wisława	imię
Wit	imię
Wita	imię
Witalis	imię
Witczak	nazwisko
Witek	imię
Witeliusz	imię
Witka	nazwisko|geograficzna
Witkiewicz	nazwisko
Witkowska	nazwisko
Witkowski	nazwisko
Witold	imię
Witolda	imię
Witomir	imię
Witomiła	imię
Witomysł	imię
Witos	nazwisko
Witosz	imię
Witosław	imię
Witosława	imię
Witołd	imię
Wittgenstein	nazwisko
Wituś	imię
Witwicka	nazwisko
Witwicki	nazwisko
Wityński	nazwisko
Więcemir	imię
Więcemił	imię
Więcemiła	imię
Więcerad	imię
Więcesław	imię
Więcesława	imię
Więckowska	nazwisko
Więckowski	nazwisko
Więcławska	nazwisko
Więcławski	nazwisko
Więsek	nazwisko
Wiłkomirski	nazwisko
Wiśniewska	nazwisko
Wiśniewski	nazwisko
Wiśniowiecki	nazwisko
Wlazło	nazwisko
Wnętrzak	nazwisko
Wodzisław	imię|geograficzna
Wodzińska	nazwisko
Wodziński	nazwisko
Wodzyńska	nazwisko
Wodzyński	nazwisko
Wojaczek	nazwisko
Wojbor	imię
Wojciech	imię
Wojciecha	imię
Wojciechowska	nazwisko
Wojciechowski	nazwisko
Wojcieszczuk	nazwisko
Wojda	nazwisko
Wojdalska	nazwisko
Wojdalski	nazwisko
Wojmir	imię
Wojnarowska	nazwisko
Wojnarowski	nazwisko
Wojnowska	nazwisko
Wojnowski	nazwisko
Wojomir	imię
Wojsław	imię
Wojsława	imię
Wojtanek	nazwisko
Wojtasińska	nazwisko
Wojtasiński	nazwisko
Wojtczak	nazwisko
Wojteczek	imię
Wojtek	imię
Wojtkowiak	nazwisko
Wojtkowska	nazwisko
Wojtkowski	nazwisko
Wojtowicz	nazwisko
Wojtul	imię
Wojtunio	imię
Wojtuś	imię
Wojtyła	nazwisko
Wokulska	nazwisko
Wokulski	nazwisko
Wolańska	nazwisko
Wolański	nazwisko
Wolf	nazwisko|imię
Wolfgang	imię
Wolimir	imię
Wolińska	nazwisko
Woliński	nazwisko
Wolmar	imię
Wolny	nazwisko
Wolska	nazwisko
Wolski	nazwisko
Wolsza	nazwisko
Wolszczan	nazwisko
Wonder	nazwisko
Wontor	nazwisko
Wontorczyk	nazwisko
Woolf	nazwisko
Worcell	nazwisko
Woronczak	nazwisko
Woronicz	nazwisko
Woroszylska	nazwisko
Woroszylski	nazwisko
Woszczyńska	nazwisko
Woszczyński	nazwisko
Wołodyjowska	nazwisko
Wołodyjowski	nazwisko
Wołosz	nazwisko
Wołoszyn	nazwisko|geograficzna
Wołowiec	nazwisko
Wołłejko	nazwisko
Woś	nazwisko
Woźniak	nazwisko
Woźniakowska	nazwisko
Woźniakowski	nazwisko
Woźnicka	nazwisko
Woźnicki	nazwisko
Woźny	nazwisko
Wrangel	nazwisko
Wright	nazwisko
Wrocisław	imię
Wrona	nazwisko
Wroniak	nazwisko
Wrońska	nazwisko
Wroński	nazwisko
Wrzesień	nazwisko
Wrześniewska	nazwisko
Wrześniewski	nazwisko
Wróbel	nazwisko
Wróblewska	nazwisko
Wróblewski	nazwisko
Wrócimir	imię
Wrócisław	imię
Wrócisława	imię
Wróciwoj	imię
Wstępnik	nazwisko
Wszebor	imię
Wszebora	imię
Wszebąd	imię
Wszeciech	imię
Wszegniew	imię
Wszemir	imię
Wszemił	imię
Wszemiła	imię
Wszerad	imię
Wszoła	nazwisko
Wujec	nazwisko
Wulkan	imię
Wundt	nazwisko
Wyatt	nazwisko
Wybicka	nazwisko
Wybicki	nazwisko
Wyczółkowska	nazwisko
Wyczółkowski	nazwisko
Wydrzyńska	nazwisko
Wydrzyński	nazwisko
Wygoda	nazwisko|geograficzna
Wyrobiec	nazwisko
Wyrzykowska	nazwisko
Wyrzykowski	nazwisko
Wysocka	nazwisko
Wysocki	nazwisko
Wysokińska	nazwisko
Wysokiński	nazwisko
Wysowski	nazwisko
Wyspiańska	nazwisko
Wyspiański	nazwisko
Wyszemir	imię
Wyszeniega	imię
Wyszesław	imię
Wyszesława	imię
Wyszomir	imię
Wyszomirska	nazwisko
Wyszomirski	nazwisko
Wyszyńska	nazwisko
Wyszyński	nazwisko
Wywrót	imię
Wójciak	nazwisko
Wójcicka	nazwisko
Wójcicki	nazwisko
Wójcik	nazwisko
Wójcikowska	nazwisko
Wójcikowski	nazwisko
Wójtowicz	nazwisko
Wądrzyk	nazwisko
Wąsowicz	nazwisko
Wąsowska	nazwisko
Wąsowski	nazwisko
Węgiel	pseudonim|nazwisko|imię
Węgrzynowska	nazwisko
Węgrzynowski	nazwisko
Węklar	nazwisko
Węsławska	nazwisko
Węsławski	nazwisko
Węzeł	nazwisko|imię
Wład	imię
Włada	imię
Władeczek	imię
Władek	imię
Władimir	imię
Władka	imię
Władysław	imię
Władysława	imię
Władyś	nazwisko
Władzia	imię
Władzio	imię
Włodarczyk	nazwisko
Włodarska	nazwisko
Włodarski	nazwisko
Włodeczek	imię
Włodek	nazwisko|imię
Włodkowic	nazwisko
Włodkowska	nazwisko
Włodkowski	nazwisko
Włodzimierz	imię|geograficzna
Włodzio	imię
Włodzisław	imię
Włodzisława	imię
Włodziwoj	imię
Włosik	nazwisko
Włościbor	imię
Włościsław	imię
Włościsława	imię
Xawery	imię
Xenia	imię
Xymena	imię
Yanina	imię
Yeats	nazwisko
Young	nazwisko
Zabawa	określenie dodatkowe|nazwisko|geograficzna
Zabielska	nazwisko
Zabielski	nazwisko
Zaborowska	nazwisko
Zaborowski	nazwisko
Zabłocka	nazwisko
Zabłocki	nazwisko
Zachariasz	imię
Zacharska	nazwisko
Zacharski	nazwisko
Zacheusz	imię
Zadura	nazwisko
Zagajewska	nazwisko
Zagajewski	nazwisko
Zagłoba	nazwisko
Zajkowska	nazwisko
Zajkowski	nazwisko
Zając	nazwisko
Zającowa	nazwisko
Zajączkowska	nazwisko
Zajączkowski	nazwisko
Zakrzewska	nazwisko
Zakrzewski	nazwisko
Zalas	nazwisko|geograficzna
Zaleska	nazwisko
Zaleski	nazwisko
Zalewska	nazwisko
Zalewski	nazwisko
Zamenhof	nazwisko
Zamojska	nazwisko
Zamojski	nazwisko
Zamoyska	nazwisko
Zamoyski	nazwisko
Zaniewska	nazwisko
Zaniewski	nazwisko
Zanussi	nazwisko
Zaorska	nazwisko
Zaorski	nazwisko
Zapolska	nazwisko
Zapolski	nazwisko
Zaratustra	imię
Zaremba	nazwisko
Zarzycka	nazwisko
Zarzycki	nazwisko
Zaręba	nazwisko
Zarębina	nazwisko
Zarębska	nazwisko
Zarębski	nazwisko
Zasław	imię|geograficzna
Zawada	nazwisko|geograficzna
Zawadka	nazwisko|geograficzna
Zawadzka	nazwisko
Zawadzki	nazwisko
Zawieyski	nazwisko
Zawistowska	nazwisko
Zawistowski	nazwisko
Zawisza	nazwisko|imię
Załuska	nazwisko
Załuski	nazwisko
Załęska	nazwisko
Załęski	nazwisko
Zbigniew	imię
Zborowska	nazwisko
Zborowski	nazwisko
Zbroimir	imię
Zbrosław	imię
Zbygniew	imię
Zbylut	imię
Zbynio	imię
Zbysio	imię
Zbyszek	imię
Zbyszko	imię
Zbysław	imię
Zbysława	imię
Zbyś	imię
Zdanowska	nazwisko
Zdanowski	nazwisko
Zdenek	imię
Zdobysław	imię
Zdrojewska	nazwisko
Zdrojewski	nazwisko
Zdzibor	imię
Zdzich	imię
Zdzicho	imię
Zdziechowska	nazwisko
Zdziechowski	nazwisko
Zdzimir	imię
Zdzisek	imię
Zdzisia	imię
Zdzisiek	imię
Zdzisio	imię
Zdzisław	imię
Zdzisława	imię
Zdziwoj	imię
Zdziś	imię
Zdziśka	imię
Zebedeusz	imię
Zebrzydowska	nazwisko
Zebrzydowski	nazwisko
Zebulon	imię
Zedong	nazwisko
Zeffirelli	nazwisko
Zefir	imię
Zefira	imię
Zefiryn	imię
Zefiryna	imię
Zeflik	imię
Zegadłowicz	nazwisko
Zeiss	nazwisko
Zelda	imię
Zembrzuska	nazwisko
Zembrzuski	nazwisko
Zenaida	imię
Zenek	imię
Zenio	imię
Zenobia	imię
Zenobiusz	imię
Zenon	imię
Zenona	imię
Zenuś	imię
Zerubabel	imię
Zeus	imię
Zgoda	nazwisko|geograficzna
Zgółkowa	nazwisko
Ziaja	nazwisko
Zielińska	nazwisko
Zieliński	nazwisko
Ziembińska	nazwisko
Ziembiński	nazwisko
Ziemińska	nazwisko
Ziemiński	nazwisko
Ziemowit	imię
Zienkiewicz	nazwisko
Zimerman	nazwisko
Zimiński	nazwisko
Zimmermann	nazwisko
Zimny	nazwisko
Zimowska	nazwisko
Zimowski	nazwisko
Zin	nazwisko
Zinaida	imię
Zinkow	nazwisko
Ziobro	nazwisko
Ziomek	nazwisko|geograficzna
Zipf	nazwisko
Ziuk	nazwisko
Ziuta	imię
Ziutek	imię
Ziutka	imię
Ziółkowska	nazwisko
Ziółkowski	nazwisko
Zięba	nazwisko
Znaniecka	nazwisko
Znaniecki	nazwisko
Zocha	imię
Zochna	imię
Zofia	imię
Zola	nazwisko
Zosia	imię
Zosieńka	imię
Zoszczenko	nazwisko
Zośka	imię
Zrínyi	nazwisko
Zuckmayer	nazwisko
Zug	nazwisko|geograficzna
Zula	imię
Zuza	imię
Zuzanka	imię
Zuzanna	imię
Zuzia	imię
Zuzka	imię
Zweig	nazwisko
Zwierzchowska	nazwisko
Zwierzchowski	nazwisko
Zwolińska	nazwisko
Zwoliński	nazwisko
Zych	nazwisko
Zyga	imię
Zygfryd	imię
Zygfryda	imię
Zygmunt	imię
Zygmuś	imię
Zyguś	imię
Zyta	imię
Zyś	imię
Zápolya	nazwisko
Złotnik	nazwisko|geograficzna
d’Alembert	nazwisko
d’Annunzio	nazwisko
d’Arc	nazwisko
d’Arquien	nazwisko
d’Estaing	nazwisko
piotruś	imię
Ćwierczakiewiczowa	nazwisko
Ćwiklińska	nazwisko
Ćwikliński	nazwisko
Łabędzka	nazwisko
Łabędzki	nazwisko
Ładyga	nazwisko
Ładysz	nazwisko
Ładysław	imię
Łagoda	nazwisko|geograficzna
Łakomy	nazwisko
Łanucha	nazwisko
Łapińska	nazwisko
Łapiński	nazwisko
Łaski	nazwisko
Ławniczak	nazwisko
Ławrientij	imię
Łazarek	nazwisko
Łazarkiewicz	nazwisko
Łazarz	imię
Łazuka	nazwisko
Łempicka	nazwisko
Łempicki	nazwisko
Łesiów	nazwisko
Łobzowska	nazwisko
Łojewska	nazwisko
Łojewski	nazwisko
Łokietkówna	nazwisko
Łomonosow	nazwisko
Łopuszańska	nazwisko
Łopuszański	nazwisko
Łozińska	nazwisko
Łoziński	nazwisko
Łoś	nazwisko
Łubieńska	nazwisko
Łubieński	nazwisko
Łubińska	nazwisko
Łubiński	nazwisko
Łucja	imię
Łucjan	imię
Łucjusz	imię
Łuczak	nazwisko
Łuczyńska	nazwisko
Łuczyński	nazwisko
Ługowska	nazwisko
Ługowski	nazwisko
Łukacijewska	nazwisko
Łukaczyński	nazwisko
Łukasiewicz	nazwisko
Łukasik	nazwisko
Łukasińska	nazwisko
Łukasiński	nazwisko
Łukasz	imię
Łukaszek	imię
Łukaszenko	nazwisko
Łukaszewicz	nazwisko
Łukaszewska	nazwisko
Łukaszewski	nazwisko
Łukaszka	nazwisko
Łukawska	nazwisko
Łukawski	nazwisko
Łukomska	nazwisko
Łukomski	nazwisko
Łuksik	nazwisko
Łuniewska	nazwisko
Łuniewski	nazwisko
Łuszczyńska	nazwisko
Łuszczyński	nazwisko
Łysenko	nazwisko
Łyszczarczyk	nazwisko
Łyszkowska	nazwisko
Łyszkowski	nazwisko
Łączkowska	nazwisko
Łączkowski	nazwisko
Łączyńska	nazwisko
Łączyński	nazwisko
Łękawski	nazwisko
Łękomir	imię
Łętocha	nazwisko
Łętowska	nazwisko
Łętowski	nazwisko
Ścibisz	nazwisko
Ścibor	nazwisko|imię
Ścibora	imię
Ściegienna	nazwisko
Ściegienny	nazwisko
Śiwa	imię
Śliwa	nazwisko
Śliwińska	nazwisko
Śliwiński	nazwisko
Ślęzak	własna|nazwisko
Śmietańska	nazwisko
Śmietański	nazwisko
Śmigły	nazwisko
Śniadecka	nazwisko
Śniadecki	nazwisko
Światosław	imię
Światowid	imię
Światozar	imię
Świder	nazwisko|geograficzna
Świderska	nazwisko
Świderski	nazwisko
Świdnicka	nazwisko
Świdnicki	nazwisko
Świdrygiełło	nazwisko
Świdzińska	nazwisko
Świdziński	nazwisko
Świeciech	imię
Świerczewska	nazwisko
Świerczewski	nazwisko
Świerczyńska	nazwisko
Świerczyński	nazwisko
Świetlana	imię
Świetlicka	nazwisko
Świetlicki	nazwisko
Świetłana	imię
Świniarska	nazwisko
Świniarski	nazwisko
Świrszczyńska	nazwisko
Świrszczyński	nazwisko
Świtalska	nazwisko
Świtalski	nazwisko
Świtoń	nazwisko
Świątek	nazwisko
Świątkowska	nazwisko
Świątkowski	nazwisko
Święcicka	nazwisko
Święcicki	nazwisko
Świętobor	imię
Świętochowska	nazwisko
Świętochowski	nazwisko
Świętomir	imię
Świętomira	imię
Świętopełk	imię
Świętosław	imię
Świętosława	imię
Świętowit	imię
Żabicka	nazwisko
Żabicki	nazwisko
Żabińska	nazwisko
Żabiński	nazwisko
Żabotyńska	nazwisko
Żabotyński	nazwisko
Żak	nazwisko
Żaka	imię
Żaklina	imię
Żaklinka	imię
Żakusia	imię
Żanecia	imię
Żaneta	imię
Żanetka	imię
Żanna	imię
Żbikowska	nazwisko
Żbikowski	nazwisko
Żdan	imię
Żebrowska	nazwisko
Żebrowski	nazwisko
Żechowski	nazwisko
Żegota	imię
Żelazny	przydomek|nazwisko
Żelazowska	nazwisko
Żelazowski	nazwisko
Żelek	imię
Żelew	nazwisko
Żeleńska	nazwisko
Żeleński	nazwisko
Żelichowska	nazwisko
Żelichowski	nazwisko
Żeligowski	nazwisko
Żelisław	imię
Żeliu	imię
Żenia	imię
Żeromska	nazwisko
Żeromski	nazwisko
Żeńka	imię
Żiwkow	nazwisko
Żiżka	nazwisko
Żmichowska	nazwisko
Żmichowski	nazwisko
Żmijewska	nazwisko
Żmijewski	nazwisko
Żmurko	nazwisko
Żochowska	nazwisko
Żochowski	nazwisko
Żuchowska	nazwisko
Żuchowski	nazwisko
Żukow	nazwisko
Żukowski	nazwisko
Żurawska	nazwisko
Żurawski	nazwisko
Żurek	nazwisko
Żurowska	nazwisko
Żurowski	nazwisko
Żuławski	nazwisko
Żwirko	nazwisko
Życińska	nazwisko
Życiński	nazwisko
Życzyńska	nazwisko
Życzyński	nazwisko
Żylis	nazwisko
Żymierski	nazwisko
Żyrinowska	nazwisko
Żyrinowski	nazwisko
Żyrosław	imię
Żyrynowska	nazwisko
Żyrynowski	nazwisko
Żywisława	imię
Żórawska	nazwisko
Żórawski	nazwisko
Żółciak	nazwisko
Żółkiewska	nazwisko
Żółkiewski	nazwisko
Żółtowska	nazwisko
Żółtowski	nazwisko
Haq	człon nazwiska
Toulouse	człon nazwiska
Hauke	człon nazwiska (herb)
Jeske	człon nazwiska (herb)
Pobóg	człon nazwiska (herb)
Korwin	człon nazwiska (herb)
Korybut	człon nazwiska (herb)
Wierusz	człon nazwiska (herb)
Lew	człon nazwiska|astr.
Andegawen	członek rodu
Bourbon	członek rodu
Burbon	członek rodu
Habsburg	członek rodu
Heraklida	członek rodu
Hohenzollern	członek rodu
Jagiellon	członek rodu
Kapetyng	członek rodu
Karoling	członek rodu
Medyceusz	członek rodu
Piast	członek rodu
Przemyślida	członek rodu
Sas	członek rodu
Walezjusz	członek rodu
Huronka	etnonim
Kęty	etnonim
Huron	etnonim
Suazi	etnonim
Tuvalu	etnonim
Babinicz	określenie dodatkowe
Bielawa	określenie dodatkowe
Tarnawa	określenie dodatkowe
Klucznik	określenie dodatkowe
Zabawa	określenie dodatkowe
Abenceragowie	osoba
Adamowie	osoba
Adasiowie	osoba
Adolfowie	osoba
Akteon	osoba
Angol	osoba
Chinol	osoba
Godot	osoba
Iks	osoba
Carrantuohille	osoba
Ilicz	patronimicum
Iliicz	patronimicum
Iljicz	patronimicum
Iwanowna	patronimicum
Wissarionowicz	patronimicum
Budda	przydomek
Chrystus	przydomek
Gioconda	przydomek
Iskariota	przydomek
Jagiellonka	przydomek
Jagiellończyk	przydomek
Krzywousty	przydomek
Opolczyk	przydomek
Podbipięta	przydomek
Probus	przydomek
Puchatek	przydomek
Rakuszanka	przydomek
Sabała	przydomek
Scypio	przydomek
Tell	przydomek
Warneńczyk	przydomek
Łokietek	przydomek
Buffalo	przydomek
Pallas	przydomek
Kadłubek	przydomek
Żelazny	przydomek
Boy	pseudonim
Gruzeł	pseudonim
Hubal	pseudonim
Kayah	pseudonim
Lenin	pseudonim
Negri	pseudonim
Nikifor	pseudonim
Or-Ot	pseudonim
Sand	pseudonim
Stalin	pseudonim
Witkacy	pseudonim
Niemen	pseudonim
Jasienica	pseudonim
Charles	pseudonim
Hill	pseudonim
Kaden	pseudonim
Lec	pseudonim
Lechoń	pseudonim
Leśmian	pseudonim
Loren	pseudonim
Malaparte	pseudonim
Moravia	pseudonim
Starr	pseudonim
Jasienica	pseudonim
George	pseudonim
Węgiel	pseudonim
XBW	pseudonim
