Aleje Jerozolimskie	aleje
Aleje Ujazdowskie	aleje
aleja 1. Armii Wojska Polskiego	aleja
aleja 1. Armii Wojska Polskiego	aleja
aleja 3 Maja	aleja
aleja 3 Maja	aleja
aleja Armii Krajowej	aleja
aleja Aleksandra Zawadzkiego	aleja
aleja Armii Krajowej	aleja
aleja Armii Ludowej	aleja
aleja Bohaterów Września	aleja
aleja Bzów	aleja
aleja Dwudziestolatków	aleja
aleja Dzieci Polskich	aleja
aleja Emila Wedla	aleja
aleja Franciszka Żwirki i Stanisława Wigury	aleja
aleja Generała Antoniego Chruściela „Montera”	aleja
aleja Generała Władysława Sikorskiego	aleja
aleja Godziny „W”	aleja
aleja Jana Chrystiana Szucha	aleja
aleja Jana Pawła II	aleja
aleja Jana Rodowicza „Anody”	aleja
aleja Jerzego Waszyngtona	aleja
aleja Karola Świerczewskiego	aleja
aleja Kazimierza Lisieckiego „Dziadka”	aleja
aleja Komisji Edukacji Narodowej	aleja
aleja Komandosów	aleja
aleja Komisji Edukacji Narodowej	aleja
aleja Krakowska	aleja
aleja Księdza Józefa Stanka	aleja
aleja Księcia Józefa Poniatowskiego	aleja
aleja Lotników	aleja
aleja Marszałka Józefa Piłsudskiego	aleja
aleja Nadziei	aleja
aleja Narcyzy Żmichowskiej	aleja
aleja Na Skarpie	aleja
aleja Niepodległości	aleja
aleja 1. Armii Wojska Polskiego	aleja
aleja Piotra Drzewieckiego	aleja
aleja Polski Walczącej	aleja
aleja Promienistych	aleja
aleja Prymasa Tysiąclecia	aleja
aleja Przyjaciół	aleja
aleja Rewolucji Październikowej	aleja
aleja Róż	aleja
aleja Rzeczypospolitej	aleja
aleja Słowiańska	aleja
aleja Stalingradzka	aleja
aleja Stanisława Lorentza	aleja
aleja Stanów Zjednoczonych	aleja
aleja Szpitala Ujazdowskiego	aleja
aleja Sztandarów	aleja
aleja 3 Maja	aleja
aleja Tysiąclecia	aleja
aleja Wielkopolski	aleja
aleja Wilanowska	aleja
aleja Wincentego Witosa	aleja
aleja Władysława Giżyckiego	aleja
aleja Władysława Reymonta	aleja
aleja Wojska Polskiego	aleja
aleja Wyścigowa	aleja
aleja Wyzwolenia	aleja
aleja Załogi Samolotu „Kościuszko”	aleja
aleja Zgrupowania Armii Krajowej „Kryska”	aleja
aleja Zgrupowania Armii Krajowej „Kryska”	aleja
aleja Zieleniecka	aleja
aleja Zjednoczenia	aleja
aleja „Solidarności”	aleja
most Gdański	most
most Generała Stefana Grota-Roweckiego	most
most Księcia Józefa Poniatowskiego	most
most Łazienkowski	most
most Północny	most
most Siekierkowski	most
most Stanisława Kierbedzia	most
most Syreny	most
most Śląsko-Dąbrowski	most
most Świętokrzyski	most
most Toruński	most
plac 1831 Roku	plac
plac 1831 Roku	plac
plac 1905 Roku	plac
plac 1905 Roku	plac
plac Aleksandra Rembowskiego	plac
plac Artura Zawiszy „Czarnego”	plac
plac Bankowy	plac
plac Bernardyński	plac
plac Czerwca 1976 Roku	plac
plac Czerwca 1976 Roku	plac
plac Defilad	plac
plac Dionizego Henkla	plac
plac Emila Młynarskiego	plac
plac Feliksa Dzierżyńskiego	plac
plac Ferenca Keresztes-Fischera	plac
plac Gabriela Narutowicza	plac
plac Generała Jana Henryka Dąbrowskiego	plac
plac Generała Józefa Hallera	plac
plac Grunwaldzki	plac
plac Grzybowski	plac
plac Gwardii	plac
plac Inwalidów	plac
plac Jedności Robotniczej	plac
plac Joachima Lelewela	plac
plac Juliana Leńskiego	plac
plac Juliusza Osterwy	plac
plac Kasztelański	plac
plac Komuny Paryskiej	plac
plac Konfederacji	plac
plac Konstytucji	plac
plac Krasińskich	plac
plac Marszałka Józefa Piłsudskiego	plac
plac Mirowski	plac
plac Na Rozdrożu	plac
plac Opolski	plac
plac Politechniki	plac
plac Powstańców Warszawy	plac
plac Przymierza	plac
plac Słoneczny	plac
plac Sokratesa Starynkiewicza	plac
plac Stanisława Małachowskiego	plac
plac Światowida	plac
plac Tadeusza Kotarbińskiego	plac
plac Teatralny	plac
plac Thomasa Woodrowa Wilsona	plac
plac Trzech Krzyży	plac
plac UNICEF	plac
plac Unii Lubelskiej	plac
plac Weteranów 1863 Roku	plac
plac Weteranów 1863 Roku	plac
plac Wileński	plac
plac Wojska Polskiego	plac
plac Wolności	plac
plac Zamkowy	plac
plac Zbawiciela	plac
plac Zofii Wóycickiej	plac
plac Zwycięstwa	plac
plac Żelaznej Bramy	plac
rondo Babka	rondo
rondo Dżochara Dudajewa	rondo
rondo Generała Augusta Emila Fieldorfa „Nila”	rondo
rondo Generała Charles’a de Gaulle’a	rondo
rondo Ignacego Daszyńskiego	rondo
rondo Jazdy Polskiej	rondo
rondo Jerzego Waszyngtona	rondo
rondo Józefa Szczepańskiego „Ziutka”	rondo
rondo Kercelak	rondo
rondo Krystyny Krachelskiej	rondo
rondo Ligi Morskiej i Rzecznej	rondo
rondo Ofiar Zbrodni Katyńskiej	rondo
rondo ONZ	rondo
rondo Organizacji Narodów Zjednoczonych	rondo
rondo Pawła Jasienicy	rondo
rondo Podporucznika Feliksa Zaremby	rondo
rondo Romana Dmowskiego	rondo
rondo Stanisława Sedlaczka	rondo
rondo Stefana Starzyńskiego	rondo
rondo Wiatraczna	rondo
rondo Zdzisława Lubomirskiego	rondo
rondo Zesłańców Syberyjskich	rondo
rondo Zgrupowania Armii Krajowej „Radosław”	rondo
rondo Zgrupowania Armii Krajowej „Radosław”	rondo
rondo Żaba	rondo
ulica 11 Listopada	ulica
ulica 11 Listopada	ulica
ulica 15 Sierpnia	ulica
ulica 15 Sierpnia	ulica
ulica 17 Stycznia	ulica
ulica 17 Stycznia	ulica
ulica 1 Maja	ulica
ulica 1 Sierpnia	ulica
ulica 1. Praskiego Pułku	ulica
ulica 1 Maja	ulica
ulica 1 Sierpnia	ulica
ulica 1. Praskiego Pułku	ulica
ulica 20. Dywizji Piechoty Wojska Polskiego	ulica
ulica 21. Pułku Piechoty Dzieci Warszawy	ulica
ulica 22 Lipca	ulica
ulica 22 Lipca	ulica
ulica 27 Grudnia	ulica
ulica 27 Grudnia	ulica
ulica 29 Listopada	ulica
ulica 29 Listopada	ulica
ulica II Armii Wojska Polskiego	ulica
ulica 6 Sierpnia	ulica
ulica 6 Sierpnia	ulica
ulica Abecadło	ulica
ulica Achillesa	ulica
ulica Adampolska	ulica
ulica Adama Asnyka	ulica
ulica Adama Ciołkosza	ulica
ulica Adama Idźkowskiego	ulica
ulica Adama Jarzębskiego	ulica
ulica Adama Mickiewicza	ulica
ulica Adama Pługa	ulica
ulica Adama Próchnika	ulica
ulica Admiralska	ulica
ulica Adolfa Dygasińskiego	ulica
ulica Adolfa Pawińskiego	ulica
ulica Adolfa Suligowskiego	ulica
ulica Adolfa Warskiego	ulica
ulica Adriatycka	ulica
ulica Afrodyty	ulica
ulica Afrykańska	ulica
ulica Agatowa	ulica
ulica Agaty	ulica
ulica Agawy	ulica
ulica Agnieszki	ulica
ulica Agrarna	ulica
ulica Agrestowa	ulica
ulica Agrykola	ulica
ulica Akacjowa	ulica
ulica Akademicka	ulica
ulica Akantu	ulica
ulica Akcent	ulica
ulica Akermańska	ulica
ulica Aksamitna	ulica
ulica Aktorska	ulica
ulica Armii Krajowej	ulica
ulica Akurat	ulica
ulica Akustyczna	ulica
ulica Akwarelowa	ulica
ulica Alabastrowa	ulica
ulica Albatrosów	ulica
ulica Alberta Einsteina	ulica
ulica Albina Jakiela	ulica
ulica Aleksandra Bardiniego	ulica
ulica Aleksandra Brücknera	ulica
ulica Aleksandra Dyżewskiego	ulica
ulica Aleksandra Fleminga	ulica
ulica Aleksandra Fredry	ulica
ulica Aleksandra Gajkowicza	ulica
ulica Aleksandra Gierymskiego	ulica
ulica Aleksandra Janowskiego	ulica
ulica Aleksandra Kamińskiego	ulica
ulica Aleksandra Kostki Napierskiego	ulica
ulica Aleksandra Kotsisa	ulica
ulica Aleksandra Kowalskiego	ulica
ulica Aleksandra Kraushara	ulica
ulica Aleksandra Krywulta	ulica
ulica Aleksandra Orłowskiego	ulica
ulica Aleksandra Patkowskiego	ulica
ulica Aleksandra Prystora	ulica
ulica Aleksandra Solińskiego	ulica
ulica Aleksandra Sulkiewicza	ulica
ulica Aleksandra Świętochowskiego	ulica
ulica Aleksandra Waszkiewicza	ulica
ulica Aleksandra Waszkowskiego	ulica
ulica Aleksandra Wejnerta	ulica
ulica Aleksandra Zelwerowicza	ulica
ulica Aleksandrowska	ulica
ulica Aleksandry Śląskiej	ulica
ulica Alka Dawidowskiego	ulica
ulica Alfreda Lampego	ulica
ulica Alfreda Nobla	ulica
ulica Algierska	ulica
ulica Alpejska	ulica
ulica Alternatywy	ulica
ulica Altowa	ulica
ulica Aluzyjna	ulica
ulica Alzacka	ulica
ulica Amarantowa	ulica
ulica Ambaras	ulica
ulica Amelińska	ulica
ulica Ametystowa	ulica
ulica Analityczna	ulica
ulica Ananasowa	ulica
ulica Anastazego Kowalczyka	ulica
ulica Andromedy	ulica
ulica Andrutowa	ulica
ulica Andrychowska	ulica
ulica Andrzejowska	ulica
ulica Andrzeja Frycza Modrzewskiego	ulica
ulica Andrzeja Munka	ulica
ulica Andrzeja Pszenickiego	ulica
ulica Andrzeja Sołtana	ulica
ulica Andrzeja Struga	ulica
ulica Andrzeja Szomańskiego	ulica
ulica Andyjska	ulica
ulica Anecińska	ulica
ulica Angorska	ulica
ulica Anieli Krzywoń	ulica
ulica Anilinowa	ulica
ulica Animuszu	ulica
ulica Annopol	ulica
ulica Antka Rozpylacza	ulica
ulica Antenowa	ulica
ulica Antoniewska	ulica
ulica Antoniny Sokolicz	ulica
ulica Antoniego Bohdziewicza	ulica
ulica Antoniego Bolesława Dobrowolskiego	ulica
ulica Antoniego Brodowskiego	ulica
ulica Antoniego Corazziego	ulica
ulica Antoniego Czechowa	ulica
ulica Antoniego Dobiszewskiego	ulica
ulica Antoniego Edwarda Odyńca	ulica
ulica Antoniego Fontany	ulica
ulica Antoniego Grabowskiego	ulica
ulica Antoniego Kacpury	ulica
ulica Antoniego Kocjana	ulica
ulica Antoniego Magiera	ulica
ulica Antoniego Malczewskiego	ulica
ulica Antoniego Pajdaka	ulica
ulica Antoniego Parola	ulica
ulica Antoniego Ponikowskiego	ulica
ulica Antoniego Solariego	ulica
ulica Antoniego Uniechowskiego	ulica
ulica Antoniego Wieczorkiewicza	ulica
ulica Antyczna	ulica
ulica Antygony	ulica
ulica Anyżkowa	ulica
ulica Apartamentowa	ulica
ulica Apenińska	ulica
ulica Aplikancka	ulica
ulica Apollina	ulica
ulica Apteczna	ulica
ulica Arabska	ulica
ulica Arachidowa	ulica
ulica Arbuzowa	ulica
ulica Archimedesa	ulica
ulica Architektów	ulica
ulica Archiwalna	ulica
ulica arcybiskupa Bodzanty	ulica
ulica Arcybiskupa Ignacego Krasickiego	ulica
ulica Arcybiskupa Jana Długosza	ulica
ulica Arcybiskupa Zygmunta Szczęsnego Felińskiego	ulica
ulica Argentyńska	ulica
ulica Arkadii	ulica
ulica Arkadowa	ulica
ulica Arkadyjska	ulica
ulica Arki Bożka	ulica
ulica Arkony	ulica
ulica Arktyczna	ulica
ulica Arkuszowa	ulica
ulica Armanda Calinescu	ulica
ulica Armatnia	ulica
ulica Armii Krajowej	ulica
ulica Arniki	ulica
ulica Aroniowa	ulica
ulica Arrasowa	ulica
ulica Arsenalska	ulica
ulica Artemidy	ulica
ulica Artura Grottgera	ulica
ulica Artura Malawskiego	ulica
ulica Artyleryjska	ulica
ulica Artystów	ulica
ulica Artystyczna	ulica
ulica Asfaltowa	ulica
ulica Aspekt	ulica
ulica Astronautów	ulica
ulica Astronomów	ulica
ulica Astrów	ulica
ulica Astry	ulica
ulica Ateńska	ulica
ulica Atlasowa	ulica
ulica Attykowa	ulica
ulica Atutowa	ulica
ulica Augustówka	ulica
ulica Augustyna Kordeckiego	ulica
ulica Augustyna Wincentego Locci	ulica
ulica Augusta Cieszkowskiego	ulica
ulica Augusta Wilkońskiego	ulica
ulica Awionetki RWD	ulica
ulica Azaliowa	ulica
ulica Babicka	ulica
ulica Babiego Lata	ulica
ulica Babie Lato	ulica
ulica Babimojska	ulica
ulica Babinicza	ulica
ulica Baborowska	ulica
ulica Baboszewska	ulica
ulica Bachmacka	ulica
ulica Bachusa	ulica
ulica Badowska	ulica
ulica Badylarska	ulica
ulica Bagatela	ulica
ulica Bagażowa	ulica
ulica Bagno	ulica
ulica Bajeczna	ulica
ulica Bajkowa	ulica
ulica Bajońska	ulica
ulica Bakalarska	ulica
ulica Bakaliowa	ulica
ulica Balaton	ulica
ulica Balbinki	ulica
ulica Baletowa	ulica
ulica Balicka	ulica
ulica Balkonowa	ulica
ulica Balladyny	ulica
ulica Balonowa	ulica
ulica Baltazara	ulica
ulica Bałtycka	ulica
ulica Bambusowa	ulica
ulica Bananowa	ulica
ulica Banderii	ulica
ulica Bandoski	ulica
ulica Banioska	ulica
ulica Bankowa	ulica
ulica Baranowska	ulica
ulica Barbary Sadowskiej	ulica
ulica Barburki	ulica
ulica Barcelońska	ulica
ulica Barcicka	ulica
ulica Barkocińska	ulica
ulica Barokowa	ulica
ulica Barska	ulica
ulica Barszczewska	ulica
ulica Bartłomieja	ulica
ulica Bartnicza	ulica
ulica Bartoszycka	ulica
ulica Bartosza Głowackiego	ulica
ulica Bartycka	ulica
ulica Barwinkowa	ulica
ulica Barwnicza	ulica
ulica Barwna	ulica
ulica Baryczków	ulica
ulica Basetli	ulica
ulica Baśniowa	ulica
ulica Batalionów Chłopskich	ulica
ulica Batalionu Armii Krajowej „Bałtyk”	ulica
ulica Batalionu Armii Krajowej „Karpaty”	ulica
ulica Batalionu Armii Krajowej „Miotła”	ulica
ulica Batalionu Armii Krajowej „Oaza”	ulica
ulica Batalionu Armii Krajowej „Olza”	ulica
ulica Batalionu Armii Krajowej „Parasol”	ulica
ulica Batalionu Armii Krajowej „Pięść”	ulica
ulica Batalionu Armii Krajowej „Ryś”	ulica
ulica Batalionu Armii Krajowej „Włochy”	ulica
ulica Batalionu Armii Krajowej „Zośka”	ulica
ulica Batalionu Armii Krajowej „Bałtyk”	ulica
ulica Batalionu Armii Krajowej „Karpaty”	ulica
ulica Batalionu Armii Krajowej „Miotła”	ulica
ulica Batalionu Armii Krajowej „Oaza”	ulica
ulica Batalionu Armii Krajowej „Olza”	ulica
ulica Batalionu Armii Krajowej „Parasol”	ulica
ulica Batalionu Armii Krajowej „Pięść”	ulica
ulica Batalionu Armii Krajowej „Ryś”	ulica
ulica Batalionu Armii Krajowej „Włochy”	ulica
ulica Batalionu Armii Krajowej „Zośka”	ulica
ulica Batalionu Platerówek	ulica
ulica Batumi	ulica
ulica Batuty	ulica
ulica Batystowa	ulica
ulica Bawełniana	ulica
ulica Bazyliańska	ulica
ulica Bażancia	ulica
ulica Beczkowa	ulica
ulica Bednarska	ulica
ulica Bedrzycha Smetany	ulica
ulica Begonii	ulica
ulica Bekasów	ulica
ulica Béli Bartóka	ulica
ulica Belgijska	ulica
ulica Belgradzka	ulica
ulica Bellony	ulica
ulica Belwederska	ulica
ulica Bełchatowska	ulica
ulica Bełdan	ulica
ulica Bełska	ulica
ulica Bełżecka	ulica
ulica Benedykta	ulica
ulica Benedykta Dybowskiego	ulica
ulica Benedykta Hertza	ulica
ulica Benedykta Polaka	ulica
ulica Berberysowa	ulica
ulica Berka Joselewicza	ulica
ulica Berestecka	ulica
ulica Berezyńska	ulica
ulica Bernardyńska	ulica
ulica Bernarda Wapowskiego	ulica
ulica Berneńska	ulica
ulica Bertolta Brechta	ulica
ulica Beskidzka	ulica
ulica Betonowa	ulica
ulica Będzińska	ulica
ulica Białej Wody	ulica
ulica Białoborska	ulica
ulica Białobrzeska	ulica
ulica Białogońska	ulica
ulica Białołęcka	ulica
ulica Białoskórnicza	ulica
ulica Białostocka	ulica
ulica Białowiejska	ulica
ulica Białowieska	ulica
ulica Białozora	ulica
ulica Biała	ulica
ulica Biały Kamień	ulica
ulica Biechowska	ulica
ulica Biedronki	ulica
ulica Bielańska	ulica
ulica Bielawska	ulica
ulica Bielska	ulica
ulica Bielszowicka	ulica
ulica Bieniewicka	ulica
ulica Biernacka	ulica
ulica Biernata z Lublina	ulica
ulica Biesiadna	ulica
ulica Bieszczadzka	ulica
ulica Bieżanowska	ulica
ulica Bieżuńska	ulica
ulica Biłgorajska	ulica
ulica Biograficzna	ulica
ulica Birżańska	ulica
ulica Biskupia	ulica
ulica Biskupa Adama Naruszewicza	ulica
ulica Biskupa Erazma Ciołka	ulica
ulica Biskupa Jana Dantyszka	ulica
ulica Biskupa Juliusza Burschego	ulica
ulica Biskupa Kajetana Sołtyka	ulica
ulica Biskupa Marcina Kromera	ulica
ulica Biskupa Władysława Bandurskiego	ulica
ulica Bitna	ulica
ulica Bitwy Grochowskiej	ulica
ulica Bitwy pod Lenino	ulica
ulica Bitwy pod Rokitną	ulica
ulica Bitwy Warszawskiej 1920 Roku	ulica
ulica Bitwy Warszawskiej 1920 Roku	ulica
ulica Biwakowa	ulica
ulica Blacharska	ulica
ulica Blaszana	ulica
ulica Bliska	ulica
ulica Blokowa	ulica
ulica Bluszczańska	ulica
ulica Bluszczowa	ulica
ulica Bławatków	ulica
ulica Błażeja	ulica
ulica Błędowska	ulica
ulica Błękitna	ulica
ulica Błogosławionego Ładysława z Gielniowa	ulica
ulica Błogosławionego Wincentego Kadłubka	ulica
ulica Błonie	ulica
ulica Błońska	ulica
ulica Błotna	ulica
ulica Bobrowiecka	ulica
ulica Bobrowa	ulica
ulica Bocheńska	ulica
ulica Bociania	ulica
ulica Boczańska	ulica
ulica Boczniaków	ulica
ulica Boczna	ulica
ulica Bogatki	ulica
ulica Bogatyńska	ulica
ulica Boglarczyków	ulica
ulica Bogoriów	ulica
ulica Bogucicka	ulica
ulica Bogumiła Zuga	ulica
ulica Bogumińska	ulica
ulica Bogunki	ulica
ulica Boguszewska	ulica
ulica Bohaterów	ulica
ulica Bohaterów Getta	ulica
ulica Bohaterów Warszawy	ulica
ulica Bohdana Żołądkowskiego	ulica
ulica Bohuna	ulica
ulica Bokserska	ulica
ulica Bolecha	ulica
ulica Bolesławicka	ulica
ulica Bolesława Gidzińskiego	ulica
ulica Bolesława Leśmiana	ulica
ulica Bolesława Limanowskiego	ulica
ulica Bolesława Podczaszyńskiego	ulica
ulica Bolesława Prusa	ulica
ulica Bolesława Rumińskiego	ulica
ulica Boleść	ulica
ulica Bolimowska	ulica
ulica Bolkowska	ulica
ulica Bombardierów	ulica
ulica Bonifraterska	ulica
ulica Bonisławska	ulica
ulica Borecka	ulica
ulica Boremlowska	ulica
ulica Borkowska	ulica
ulica Borków	ulica
ulica Borowej Góry	ulica
ulica Borowiecka	ulica
ulica Borowika	ulica
ulica Borowa	ulica
ulica Borówkowa	ulica
ulica Borsucza	ulica
ulica Boruty	ulica
ulica Boryny	ulica
ulica Borysławska	ulica
ulica Boryszewska	ulica
ulica Borzęcińska	ulica
ulica Borzymowska	ulica
ulica Bosmańska	ulica
ulica Botaniczna	ulica
ulica Braci Pillatich	ulica
ulica Braci Wagów	ulica
ulica Braci Załuskich	ulica
ulica Bracka	ulica
ulica Bracławska	ulica
ulica Bramka	ulica
ulica Braniewska	ulica
ulica Brata Alberta	ulica
ulica Braterstwa Broni	ulica
ulica Bratka	ulica
ulica Bratnia	ulica
ulica Brazylijska	ulica
ulica Brązownicza	ulica
ulica Brochowska	ulica
ulica Brodnicka	ulica
ulica Brodzik	ulica
ulica Bronisława Czecha	ulica
ulica Bronisława Dobrzańskiego	ulica
ulica Bronisława Gembarzewskiego	ulica
ulica Bronisława Pietraszewicza „Lota”	ulica
ulica Bronisława Trentowskiego	ulica
ulica Bronisława Wesołowskiego	ulica
ulica Bronisława Wieczorkiewicza	ulica
ulica Broniwoja	ulica
ulica Bronowska	ulica
ulica Browarna	ulica
ulica Bródnowska	ulica
ulica Brukselska	ulica
ulica Brunona Kicińskiego	ulica
ulica Brunona Schulza	ulica
ulica Bruszewska	ulica
ulica Bruzdowa	ulica
ulica Brwinowska	ulica
ulica Brygady Pościgowej	ulica
ulica Brygadzistów	ulica
ulica Brygad Międzynarodowych	ulica
ulica Brylantowa	ulica
ulica Brylowska	ulica
ulica Brzegowa	ulica
ulica Brzeska	ulica
ulica Brzeziny	ulica
ulica Brzezińska	ulica
ulica Brzeżek	ulica
ulica Brzoskwiniowa	ulica
ulica Brzostowska	ulica
ulica Brzozowa	ulica
ulica Brzozowy Lasek	ulica
ulica Brzozowy Zagajnik	ulica
ulica Buchalteryjna	ulica
ulica Budki Szczęśliwickie	ulica
ulica Budowlana	ulica
ulica Budrysów	ulica
ulica Budy	ulica
ulica Bugaj	ulica
ulica Bukietowa	ulica
ulica Bukowiecka	ulica
ulica Bukowińska	ulica
ulica Bukowa	ulica
ulica Bukszpanowa	ulica
ulica Bulwarowa	ulica
ulica Buławy	ulica
ulica Bułgarska	ulica
ulica Buńczuk	ulica
ulica Buraczana	ulica
ulica Burakowska	ulica
ulica Burgaska	ulica
ulica Burmistrzowska	ulica
ulica Bursztynowa	ulica
ulica Burzliwa	ulica
ulica Buska	ulica
ulica Busolowa	ulica
ulica Buszycka	ulica
ulica Bychowska	ulica
ulica Byczyńska	ulica
ulica Bylicowa	ulica
ulica Bysławska	ulica
ulica Bystra	ulica
ulica Bystrzycka	ulica
ulica Byszewska	ulica
ulica Bytomska	ulica
ulica Bzowa	ulica
ulica Calineczki	ulica
ulica Calowa	ulica
ulica Canaletta	ulica
ulica Capri	ulica
ulica Carla Goldoniego	ulica
ulica Cechowa	ulica
ulica Cecylii Śniegockiej	ulica
ulica Cedrowa	ulica
ulica Cedzyńska	ulica
ulica Cegielniana	ulica
ulica Ceglana	ulica
ulica Cegłowska	ulica
ulica Celestynowska	ulica
ulica Celna	ulica
ulica Celofanowa	ulica
ulica Celtów	ulica
ulica Celulozy	ulica
ulica Cementowa	ulica
ulica Centralna	ulica
ulica Centurii	ulica
ulica Ceramiczna	ulica
ulica Cesarskiej Korony	ulica
ulica Chabrowa	ulica
ulica Chabrów	ulica
ulica Chałupnicza	ulica
ulica Chełchowska	ulica
ulica Chełmska	ulica
ulica Chełmżyńska	ulica
ulica Chemiczna	ulica
ulica Chęcińska	ulica
ulica Chińskiej Róży	ulica
ulica Chlebowa	ulica
ulica Chlewińska	ulica
ulica Chlubna	ulica
ulica Chłodnicza	ulica
ulica Chłodna	ulica
ulica Chmielna	ulica
ulica Chmurna	ulica
ulica Chochołowska	ulica
ulica Chocimska	ulica
ulica Chodakowska	ulica
ulica Chodecka	ulica
ulica Chodzieska	ulica
ulica Chodzonego	ulica
ulica Choinkowa	ulica
ulica Chojnowska	ulica
ulica Chorągwi Pancernej	ulica
ulica Chorzelska	ulica
ulica Chorzowska	ulica
ulica Chotomowska	ulica
ulica Chóralna	ulica
ulica Christa Botewa	ulica
ulica Chroszczewska	ulica
ulica Chryzantemy	ulica
ulica Chylicka	ulica
ulica Chylońska	ulica
ulica Chyrowska	ulica
ulica Ciasna	ulica
ulica Cichej Wody	ulica
ulica Cichociemnych	ulica
ulica Cicha	ulica
ulica Cichy Zakątek	ulica
ulica Ciechanowska	ulica
ulica Ciechocińska	ulica
ulica Ciekawa	ulica
ulica Ciemna	ulica
ulica Cienista	ulica
ulica Ciepielowska	ulica
ulica Cieplarniana	ulica
ulica Cieplicka	ulica
ulica Ciepła	ulica
ulica Cierlicka	ulica
ulica Ciesielska	ulica
ulica Cieszyńska	ulica
ulica Cieślewskich	ulica
ulica Cietrzewia	ulica
ulica Cisowa	ulica
ulica Ciszewska	ulica
ulica Ciupagi	ulica
ulica Ciżemki	ulica
ulica Cmentarna	ulica
ulica Codzienna	ulica
ulica Cokołowa	ulica
ulica Cudne Manowce	ulica
ulica Cudnowska	ulica
ulica Cukrownicza	ulica
ulica Cybernetyki	ulica
ulica Cyganeczki	ulica
ulica Cygańska	ulica
ulica Cyklamenowa	ulica
ulica Cyklamenów	ulica
ulica Cylichowska	ulica
ulica Cymbalistów	ulica
ulica Cynamonowa	ulica
ulica Cynowa	ulica
ulica Cypriana Godebskiego	ulica
ulica Cypriana Kamila Norwida	ulica
ulica Cypryjska	ulica
ulica Cyprysowa	ulica
ulica Cyraneczki	ulica
ulica Cyrhli	ulica
ulica Cyrklowa	ulica
ulica Cyrkonii	ulica
ulica Cyrulików	ulica
ulica Cytadeli	ulica
ulica Cytrynowa	ulica
ulica Czajki	ulica
ulica Czapelska	ulica
ulica Czapli	ulica
ulica Czapnicza	ulica
ulica Czardasza	ulica
ulica Czarna Droga	ulica
ulica Czarnocińska	ulica
ulica Czarnoleska	ulica
ulica Czarnołęcka	ulica
ulica Czarnomorska	ulica
ulica Czarnuszki	ulica
ulica Czarodzieja	ulica
ulica Czatów	ulica
ulica Cząstkowska	ulica
ulica Czechowicka	ulica
ulica Czekanowska	ulica
ulica Czekoladowa	ulica
ulica Czeladnicza	ulica
ulica Czempińska	ulica
ulica Czeremchowa	ulica
ulica Czereśniowa	ulica
ulica Czerniakowska	ulica
ulica Czerniowiecka	ulica
ulica Czerska	ulica
ulica Czerwińska	ulica
ulica Czerwona Droga	ulica
ulica Czerwonego Kapturka	ulica
ulica Czerwonego Krzyża	ulica
ulica Czerwonych Beretów	ulica
ulica Czerwonych Maków	ulica
ulica Czerwonych Wierchów	ulica
ulica Czeska	ulica
ulica Czesława Kłosia	ulica
ulica Czesława Przybylskiego	ulica
ulica Czesława Tańskiego	ulica
ulica Czesława Witoszyńskiego	ulica
ulica Cześnika	ulica
ulica Częstochowska	ulica
ulica Człuchowska	ulica
ulica Czołgistów	ulica
ulica Czołowa	ulica
ulica Czorsztyńska	ulica
ulica Czółenkowa	ulica
ulica Czterech Wiatrów	ulica
ulica Czubatki	ulica
ulica Czujna	ulica
ulica Czwartaków	ulica
ulica IV Poprzeczna	ulica
ulica Czynszowa	ulica
ulica Czysta	ulica
ulica Czytelnicza	ulica
ulica Czyżewska	ulica
ulica Ćmielowska	ulica
ulica Daglezji	ulica
ulica Daków	ulica
ulica Daktylowa	ulica
ulica Dalanowska	ulica
ulica Daleka	ulica
ulica Daleszycka	ulica
ulica Dalibora	ulica
ulica Dalii	ulica
ulica Daliowa	ulica
ulica Daniłowiczowska	ulica
ulica Daniszewska	ulica
ulica Dankowicka	ulica
ulica Dantego	ulica
ulica Danusi	ulica
ulica Darłowska	ulica
ulica Darniowa	ulica
ulica Daszowska	ulica
ulica Dawidowska	ulica
ulica Dawna	ulica
ulica Dąbrowiecka	ulica
ulica Dąbrowszczaków	ulica
ulica Dąbrowy	ulica
ulica Dąbrówki	ulica
ulica Dedala	ulica
ulica Dekarska	ulica
ulica Delfina	ulica
ulica Denarowa	ulica
ulica Deotymy	ulica
ulica Deptak	ulica
ulica Derby	ulica
ulica Dereniowa	ulica
ulica Derkaczy	ulica
ulica Derwida	ulica
ulica Deseniowa	ulica
ulica Deszczowa	ulica
ulica Dewajtis	ulica
ulica Dębicka	ulica
ulica Dębinki	ulica
ulica Dęblińska	ulica
ulica Dębowa	ulica
ulica Dęby	ulica
ulica Diamentowa	ulica
ulica Dionizosa	ulica
ulica Długa	ulica
ulica Długomiła	ulica
ulica Długopolska	ulica
ulica Długorzeczna	ulica
ulica Dłutowska	ulica
ulica Dmuchawcowa	ulica
ulica Dobka z Oleśnicy	ulica
ulica Dobosza	ulica
ulica Dobrodzieja	ulica
ulica Dobrogniewa	ulica
ulica Dobrowoja	ulica
ulica Dobra	ulica
ulica Dojazdowa	ulica
ulica Dokerów	ulica
ulica Dolina Służewiecka	ulica
ulica Dolnośląska	ulica
ulica Dolna	ulica
ulica Dolomitowa	ulica
ulica Dołowa	ulica
ulica Domaniewska	ulica
ulica Dominikańska	ulica
ulica Dominiki	ulica
ulica Dominika Merliniego	ulica
ulica Domowa	ulica
ulica Don Kichota	ulica
ulica Dorodna	ulica
ulica Dorohuska	ulica
ulica Doroty Kłuszyńskiej	ulica
ulica Dorotowska	ulica
ulica Dorycka	ulica
ulica Dostatnia	ulica
ulica Dostępna	ulica
ulica Dowcip	ulica
ulica Dowódców	ulica
ulica Dożynkowa	ulica
ulica Do Fortu	ulica
ulica Draceny	ulica
ulica Dragonów	ulica
ulica Drapińska	ulica
ulica Drawska	ulica
ulica Drewniana	ulica
ulica Drewnicka	ulica
ulica Drezdeńska	ulica
ulica Drobiazg	ulica
ulica Droga Golfowa	ulica
ulica Drogistów	ulica
ulica Drogomilska	ulica
ulica Drogowa	ulica
ulica Drohicka	ulica
ulica Drohobycka	ulica
ulica Drozdowa	ulica
ulica Drożdżowa	ulica
ulica Druciana	ulica
ulica II Poprzeczna	ulica
ulica II Armii Wojska Polskiego	ulica
ulica Drukarzy	ulica
ulica Drumli	ulica
ulica Drużynowa	ulica
ulica Drwali	ulica
ulica Drzemlika	ulica
ulica Drzeworytników	ulica
ulica Dubieńska	ulica
ulica Duchnicka	ulica
ulica Dudziarska	ulica
ulica Dukatowa	ulica
ulica Dukielska	ulica
ulica Dulczyńska	ulica
ulica Dumki	ulica
ulica Dunajecka	ulica
ulica Duninów	ulica
ulica Dusznicka	ulica
ulica Dworcowa	ulica
ulica Dworkowa	ulica
ulica Dworska	ulica
ulica Dwóch Mieczy	ulica
ulica XII Poprzeczna	ulica
ulica 21. Pułku Piechoty Dzieci Warszawy	ulica
ulica 20. Dywizji Piechoty Wojska Polskiego	ulica
ulica Dwusieczna	ulica
ulica Dychowska	ulica
ulica Dylewska	ulica
ulica Dyliżansowa	ulica
ulica Dymińska	ulica
ulica Dymitra Mendelejewa	ulica
ulica Dymna	ulica
ulica Dynamiczna	ulica
ulica Dynarska	ulica
ulica Dynasy	ulica
ulica Dyngus	ulica
ulica Dynowska	ulica
ulica Dywizjonu 303	ulica
ulica Dywizjonu 303	ulica
ulica Dywizjonu 303	ulica
ulica Dywizjonu Armii Krajowej „Jeleń”	ulica
ulica Dywizjonu Armii Krajowej „Jeleń”	ulica
ulica Działdowska	ulica
ulica Działkowa	ulica
ulica Działowa	ulica
ulica Działyńczyków	ulica
ulica Dziatwy	ulica
ulica Dzidka Warszawiaka	ulica
ulica Dziecięca	ulica
ulica Dzieci Warszawy	ulica
ulica Dziekania	ulica
ulica Dziekanowska	ulica
ulica Dzielnicowa	ulica
ulica Dzielna	ulica
ulica Dziennikarska	ulica
ulica Dzierzby	ulica
ulica Dzierzgońska	ulica
ulica Dzierżoniowska	ulica
ulica X Poprzeczna	ulica
ulica Dziewanny	ulica
ulica Dziewanowska	ulica
ulica Dziewiarska	ulica
ulica IX Poprzeczna	ulica
ulica Dziewierza	ulica
ulica Dziewosłęby	ulica
ulica Dzięcieliny	ulica
ulica Dzięcioła	ulica
ulica Dzięgielowa	ulica
ulica Dzika	ulica
ulica Dzikiej Kaczki	ulica
ulica Dzikiej Róży	ulica
ulica Dziupli	ulica
ulica Dziwożony	ulica
ulica Dzwonkowa	ulica
ulica Dzwonnicza	ulica
ulica Dźwiękowa	ulica
ulica Dźwigowa	ulica
ulica Dźwińska	ulica
ulica Ebro	ulica
ulica Echa Leśne	ulica
ulica Edmunda Jankowskiego	ulica
ulica Edmunda Jana Osmańczyka	ulica
ulica Edwarda Dembowskiego	ulica
ulica Edwarda Fondamińskiego	ulica
ulica Edwarda Gibalskiego	ulica
ulica Edwarda Jelinka	ulica
ulica Edwarda Stachury	ulica
ulica Edwarda Szymańskiego	ulica
ulica Edwarda Warchałowskiego	ulica
ulica Edwarda Wittiga	ulica
ulica Efraima Schroegera	ulica
ulica Egejska	ulica
ulica Egipska	ulica
ulica Ekologiczna	ulica
ulica Ekspresowa	ulica
ulica Elbląska	ulica
ulica Elegancka	ulica
ulica Elegijna	ulica
ulica Elekcyjna	ulica
ulica Elektoralna	ulica
ulica Elektronowa	ulica
ulica Elektryczna	ulica
ulica Elektry	ulica
ulica Elizy Orzeszkowej	ulica
ulica Elsterska	ulica
ulica Elżbiety Drużbackiej	ulica
ulica Emaliowa	ulica
ulica Emanuela Ringelbluma	ulica
ulica Emiliana Konopczyńskiego	ulica
ulica Emilii Gierczak	ulica
ulica Emilii Plater	ulica
ulica Emila Zegadłowicza	ulica
ulica Emila Zoli	ulica
ulica Encyklopedyczna	ulica
ulica Energetyczna	ulica
ulica Epopei	ulica
ulica Erazma z Zakroczymia	ulica
ulica Ernesta Malinowskiego	ulica
ulica Esej	ulica
ulica Eskimoska	ulica
ulica Eskulapów	ulica
ulica Esperanto	ulica
ulica Estery Stróżeckiej	ulica
ulica Estońska	ulica
ulica Estrady	ulica
ulica Etiudy Rewolucyjnej	ulica
ulica Eugeniusza Bocheńskiego „Dubańca”	ulica
ulica Eugeniusza Bodo	ulica
ulica Eugeniusza Horbaczewskiego	ulica
ulica Eugeniusza Kwiatkowskiego	ulica
ulica Eugeniusza Lokajskiego	ulica
ulica Eugeniusza Romera	ulica
ulica Eugeniusza Szwankowskiego	ulica
ulica Europejska	ulica
ulica Eustachego Tyszkiewicza	ulica
ulica Ewy	ulica
ulica Ezopa	ulica
ulica Fabiańska	ulica
ulica Fabryczna	ulica
ulica Fajansowa	ulica
ulica Falenicka	ulica
ulica Falentyńska	ulica
ulica Falęcka	ulica
ulica Falkowska	ulica
ulica Familijna	ulica
ulica Fanfarowa	ulica
ulica Fantazyjna	ulica
ulica Faraona	ulica
ulica Farbiarska	ulica
ulica Farysa	ulica
ulica Fasolowa	ulica
ulica Faszynowa	ulica
ulica Fausta	ulica
ulica Faustyna Czerwijowskiego	ulica
ulica Fawory	ulica
ulica Feliksa Pancera	ulica
ulica Ferdynanda Magellana	ulica
ulica Figara	ulica
ulica Figowa	ulica
ulica Filarecka	ulica
ulica Filipiny Płaskowickiej	ulica
ulica Filipinki	ulica
ulica Filmowa	ulica
ulica Filomatów	ulica
ulica Filona	ulica
ulica Filtrowa	ulica
ulica Finałowa	ulica
ulica Finlandzka	ulica
ulica Fińska	ulica
ulica Fioletowa	ulica
ulica Fiołków	ulica
ulica Firletki	ulica
ulica Fizyków	ulica
ulica Fizylierów	ulica
ulica Flagowa	ulica
ulica Flamenco	ulica
ulica Fletniowa	ulica
ulica Floksów	ulica
ulica Floriana	ulica
ulica Floriana Marciniaka	ulica
ulica Floriana Znanieckiego	ulica
ulica Floriańska	ulica
ulica Flory	ulica
ulica Foksal	ulica
ulica Foliałowa	ulica
ulica Folwarczna	ulica
ulica Forsycji	ulica
ulica Forteczna	ulica
ulica Fortel	ulica
ulica Fortowa	ulica
ulica Fortuny	ulica
ulica Fort Wola	ulica
ulica Fosa	ulica
ulica Franciszka Achera	ulica
ulica Franciszka Bohomolca	ulica
ulica Franciszka Groëra	ulica
ulica Franciszka Grzelszczaka	ulica
ulica Franciszka Hynka	ulica
ulica Franciszka Ilskiego	ulica
ulica Franciszka Jacka Bartoszka	ulica
ulica Franciszka Janika	ulica
ulica Franciszka Jóźwiaka	ulica
ulica Franciszka Karpińskiego	ulica
ulica Franciszka Kawy	ulica
ulica Franciszka Klimczaka	ulica
ulica Franciszka Kniaźnina	ulica
ulica Franciszka Kostrzewskiego	ulica
ulica Franciszka Ksawerego Dmochowskiego	ulica
ulica Franciszka Łukaszczyka	ulica
ulica Franciszka Marii Lanciego	ulica
ulica Franciszka Raszei	ulica
ulica Franciszka Salezego Jezierskiego	ulica
ulica Franciszka Szuberta	ulica
ulica Franciszka Żwirki	ulica
ulica Franciszkańska	ulica
ulica Francuska	ulica
ulica Frascati	ulica
ulica Fraszka	ulica
ulica Fraszki	ulica
ulica Fregaty	ulica
ulica Freta	ulica
ulica Frezji	ulica
ulica Fromborska	ulica
ulica Frontowa	ulica
ulica Fryderyka Chopina	ulica
ulica Fryderyka Joliot-Curie	ulica
ulica Fryderyka Szopena	ulica
ulica Frygijska	ulica
ulica Frysztacka	ulica
ulica Fukierów	ulica
ulica Fuksji	ulica
ulica Fundamentowa	ulica
ulica Furmańska	ulica
ulica Gabriela	ulica
ulica Gabrieli Zapolskiej	ulica
ulica Gabriela Narutowicza	ulica
ulica Gaik	ulica
ulica Gajdy	ulica
ulica Gajowa	ulica
ulica Galaktyki	ulica
ulica Galileusza	ulica
ulica Galla Anonima	ulica
ulica Gallijska	ulica
ulica Galopu	ulica
ulica Garażowa	ulica
ulica Garbarska	ulica
ulica Gardenii	ulica
ulica Garłaczy	ulica
ulica Garncarska	ulica
ulica Garwolińska	ulica
ulica Gawędziarzy	ulica
ulica Gawota	ulica
ulica Gazowa	ulica
ulica Gąbińska	ulica
ulica Gąsek	ulica
ulica Gąsienicowa	ulica
ulica Gąsocińska	ulica
ulica Gdańska	ulica
ulica Gdecka	ulica
ulica Gdyńska	ulica
ulica Gedymina	ulica
ulica Generała Waltera	ulica
ulica Generała Antoniego Józefa Madalińskiego	ulica
ulica Generała Bolesława Szareckiego	ulica
ulica Generała Bronisława Bohaterewicza	ulica
ulica Generała Czesława Ludwika Rybińskiego	ulica
ulica Generała Dezyderego Adama Chłapowskiego	ulica
ulica Generała Emila Fieldorfa	ulica
ulica Generała Eryka Dahlbergha	ulica
ulica Generała Felicjana Sławoja-Składkowskiego	ulica
ulica Generała Francesco Nullo	ulica
ulica Generała Franciszka Kleeberga	ulica
ulica Generała Franciszka Rymkiewicza	ulica
ulica Generała Henryka Dembińskiego	ulica
ulica Generała Ignacego Prądzyńskiego	ulica
ulica Generała Jakuba Jasińskiego	ulica
ulica Generała Jana Zygmunta Skrzyneckiego	ulica
ulica Generała Jarosława Dąbrowskiego	ulica
ulica Generała Józefa Bema	ulica
ulica Generała Józefa Chłopickiego	ulica
ulica Generała Józefa Hauke-Bosaka	ulica
ulica Generała Józefa Longina Sowińskiego	ulica
ulica Generała Józefa Sułkowskiego	ulica
ulica Generała Józefa Zajączka	ulica
ulica Generała Karola Ziemskiego „Wachnowskiego”	ulica
ulica Generała Kazimierza Pułaskiego	ulica
ulica Generała Kazimierza Sosnkowskiego	ulica
ulica Generała Krzysztofa Arciszewskiego	ulica
ulica Generała Leonarda Skierskiego	ulica
ulica Generała Leopolda Okulickiego	ulica
ulica Generała Lucjana Żeligowskiego	ulica
ulica Generała Ludwika Mierosławskiego	ulica
ulica Generała Marcina Kątskiego	ulica
ulica Generała Mariana Langiewicza	ulica
ulica Generała Mariusza Zaruskiego	ulica
ulica Generała Michała Paca	ulica
ulica Generała Michała Tokarzewskiego-Karaszewicza	ulica
ulica Generała Mikołaja Bołtucia	ulica
ulica Generała Romana Abrahama	ulica
ulica Generała Stanisława Fiszera	ulica
ulica Generała Stanisława Maczka	ulica
ulica Generała Stanisława Rostworowskiego	ulica
ulica Generała Stanisława Sosabowskiego	ulica
ulica Generała Sylwestra Kaliskiego	ulica
ulica Generała Tadeusza Bora-Komorowskiego	ulica
ulica Generała Tadeusza Korsaka	ulica
ulica Generała Tadeusza Kościuszki	ulica
ulica Generała Tadeusza Kutrzeby	ulica
ulica Generała Tadeusza Pełczyńskiego	ulica
ulica Generała Waleriana Czumy	ulica
ulica Generała Walerego Wróblewskiego	ulica
ulica Generała Wiktora Thommeego	ulica
ulica Generała Władysława Andersa	ulica
ulica Generała Władysława Sikorskiego	ulica
ulica Genewska	ulica
ulica Geodetów	ulica
ulica Geodezyjna	ulica
ulica Geograficzna	ulica
ulica Geologiczna	ulica
ulica Geometryczna	ulica
ulica Geranii	ulica
ulica Gerberowa	ulica
ulica Gerwazego	ulica
ulica Gębicka	ulica
ulica Gęsta	ulica
ulica Gęślarska	ulica
ulica Gibraltarska	ulica
ulica Giełdowa	ulica
ulica Gierdawska	ulica
ulica Giermków	ulica
ulica Giewont	ulica
ulica Gilarska	ulica
ulica Gimnastyczna	ulica
ulica Gimnazjalna	ulica
ulica Gitarowa	ulica
ulica Gizów	ulica
ulica Gladioli	ulica
ulica Glebowa	ulica
ulica Glicynii	ulica
ulica Gliwicka	ulica
ulica Globusowa	ulica
ulica Gładka	ulica
ulica Głębocka	ulica
ulica Głęboka	ulica
ulica Głogowska	ulica
ulica Głogowa	ulica
ulica Główna	ulica
ulica Głubczycka	ulica
ulica Głucha	ulica
ulica Głuszca	ulica
ulica Głuszycka	ulica
ulica Gniazdowska	ulica
ulica Gniewkowska	ulica
ulica Gnieźnieńska	ulica
ulica Gocławska	ulica
ulica Goczałkowicka	ulica
ulica Godlewska	ulica
ulica Godowska	ulica
ulica Godziszowska	ulica
ulica Gogolińska	ulica
ulica Goleszowska	ulica
ulica Golędzinowska	ulica
ulica Golfowa	ulica
ulica Goławicka	ulica
ulica Gołdapska	ulica
ulica Gołębia	ulica
ulica Gołkowska	ulica
ulica Gołuchowska	ulica
ulica Gontarska	ulica
ulica Goplańska	ulica
ulica Gorajska	ulica
ulica Goraszewska	ulica
ulica Gorlicka	ulica
ulica Goryczkowa	ulica
ulica Gorzelnicza	ulica
ulica Gorzkiewki	ulica
ulica Gorzykowska	ulica
ulica Gospodarcza	ulica
ulica Gostyńska	ulica
ulica Gościeradowska	ulica
ulica Gościniec	ulica
ulica Gościnna	ulica
ulica Gotarda	ulica
ulica Gottfrieda Leibniza	ulica
ulica Gottlieba Daimlera	ulica
ulica Gotycka	ulica
ulica Goworka	ulica
ulica Goworowska	ulica
ulica Gozdawitów	ulica
ulica Goździków	ulica
ulica Góralska	ulica
ulica Górczewska	ulica
ulica Górna Droga	ulica
ulica Górnośląska	ulica
ulica Górna	ulica
ulica Górska	ulica
ulica Grabalówki	ulica
ulica Grabiny	ulica
ulica Grabowska	ulica
ulica Grabowa	ulica
ulica Grafitowa	ulica
ulica Grajewska	ulica
ulica Graniczna	ulica
ulica Granitowa	ulica
ulica Granowska	ulica
ulica Grawerska	ulica
ulica Grażyny Bacewiczówny	ulica
ulica Grażyny	ulica
ulica Grecka	ulica
ulica Grenadierów	ulica
ulica Grenady	ulica
ulica Grębałowska	ulica
ulica Gręplarska	ulica
ulica Grobelska	ulica
ulica Grocholicka	ulica
ulica Grochowska	ulica
ulica Grodkowska	ulica
ulica Grodzieńska	ulica
ulica Grodziska	ulica
ulica Grodzka	ulica
ulica Gronowa	ulica
ulica Groszowicka	ulica
ulica Groteski	ulica
ulica Grotowska	ulica
ulica Grójecka	ulica
ulica Gruchacza	ulica
ulica Gruntowa	ulica
ulica Grupy Armii Krajowej „Kampinos”	ulica
ulica Grupy Armii Krajowej „Północ”	ulica
ulica Grupy Armii Krajowej „Kampinos”	ulica
ulica Grupy Armii Krajowej „Północ”	ulica
ulica Gruszy	ulica
ulica Gruzińska	ulica
ulica Gryczana	ulica
ulica Gryfitów	ulica
ulica Grzegorza Fitelberga	ulica
ulica Grzybowska	ulica
ulica Grzybowa	ulica
ulica Grzymalitów	ulica
ulica Grzywaczy	ulica
ulica Gubinowska	ulica
ulica Guliwera	ulica
ulica Gułowska	ulica
ulica Guńki	ulica
ulica Gustawa	ulica
ulica Gustawa Daniłowskiego	ulica
ulica Gustawa Morcinka	ulica
ulica Gustawa Reichera	ulica
ulica Guźca	ulica
ulica Gwardii	ulica
ulica Gwarków	ulica
ulica Gwiaździsta	ulica
ulica Gwintowa	ulica
ulica Gżegżółki	ulica
ulica Haczowska	ulica
ulica Hafciarska	ulica
ulica Hajduczka	ulica
ulica Hajnowska	ulica
ulica Hajoty	ulica
ulica Haliny Krahelskiej	ulica
ulica Halki	ulica
ulica Halna	ulica
ulica Handlowa	ulica
ulica Hanki Czaki	ulica
ulica Hanki Ordonówny	ulica
ulica Hanki Sawickiej	ulica
ulica Hanki Sawickiej	ulica
ulica Hansa Christiana Andersena	ulica
ulica Harcerska	ulica
ulica Harendy	ulica
ulica Harfowa	ulica
ulica Harmonistów	ulica
ulica Harnasie	ulica
ulica Haubicy	ulica
ulica Hawajska	ulica
ulica Hebanowa	ulica
ulica Hejnałowa	ulica
ulica Hektarowa	ulica
ulica Heleny Junkiewicz	ulica
ulica Heleny Kozłowskiej	ulica
ulica Heleny Modrzejewskiej	ulica
ulica Heleny Rzeszotarskiej	ulica
ulica Heleny Wolff	ulica
ulica Heliotropów	ulica
ulica Heloizy	ulica
ulica Henrykowska	ulica
ulica Henryka Arctowskiego	ulica
ulica Henryka Barona	ulica
ulica Henryka Jędrzejowskiego	ulica
ulica Henryka Małkowskiego	ulica
ulica Henryka Melcera-Szczawińskiego	ulica
ulica Henryka Mierzejewskiego	ulica
ulica Henryka Opieńskiego	ulica
ulica Henryka Raabego	ulica
ulica Henryka Rodakowskiego	ulica
ulica Henryka Rutkowskiego	ulica
ulica Henryka Siemiradzkiego	ulica
ulica Henryka Sienkiewicza	ulica
ulica Henryka Sternhela	ulica
ulica Henryka Sucharskiego	ulica
ulica Henryka Wieniawskiego	ulica
ulica Henryka Wierzchowskiego	ulica
ulica Herakliusza Billewicza	ulica
ulica Herbaciana	ulica
ulica Herbowa	ulica
ulica Hermanowska	ulica
ulica Heroldów	ulica
ulica Hery	ulica
ulica Hetmana Jana Karola Chodkiewicza	ulica
ulica Hetmana Pawła Jana Sapiehy	ulica
ulica Hetmana Stanisława Jana Jabłonowskiego	ulica
ulica Hetmana Stanisława Żółkiewskiego	ulica
ulica Hetmana Stefana Czarnieckiego	ulica
ulica Hetmańska	ulica
ulica Hiacyntowa	ulica
ulica Hieroglif	ulica
ulica Himalajska	ulica
ulica Hipolitowo	ulica
ulica Hipolita Wawelberga	ulica
ulica Hipoteczna	ulica
ulica Hipotezy	ulica
ulica Hodowlana	ulica
ulica Holenderska	ulica
ulica Hołubcowa	ulica
ulica Homera	ulica
ulica Honoriusza Balzaka	ulica
ulica Horacego	ulica
ulica Horodelska	ulica
ulica Hortensji	ulica
ulica Hoserów	ulica
ulica Hoża	ulica
ulica Hrubieszowska	ulica
ulica Hubalczyków	ulica
ulica Hucisko	ulica
ulica Huculska	ulica
ulica Huczna	ulica
ulica Hufcowa	ulica
ulica Hugona Steinhausa	ulica
ulica Humanistów	ulica
ulica Humańska	ulica
ulica Husarii	ulica
ulica Husarska	ulica
ulica Hutnicza	ulica
ulica I Poprzeczna	ulica
ulica Iberyjska	ulica
ulica Ibisa	ulica
ulica Icchaka Lejba Pereca	ulica
ulica Igańska	ulica
ulica Iglasta	ulica
ulica Ignacego Domeyki	ulica
ulica Ignacego Kruszewskiego	ulica
ulica Ignacego Łukasiewicza	ulica
ulica Ignacego Paderewskiego	ulica
ulica Ignacego Potockiego	ulica
ulica Igrzyskowa	ulica
ulica II Poprzeczna	ulica
ulica III Poprzeczna	ulica
ulica III Poprzeczna	ulica
ulica II Armii Wojska Polskiego	ulica
ulica II Armii Wojska Polskiego	ulica
ulica II Poprzeczna	ulica
ulica II Rejonu Armii Krajowej	ulica
ulica II Rejonu Armii Krajowej	ulica
ulica II Rejonu Armii Krajowej	ulica
ulica Ikara	ulica
ulica Ilji Miecznikowa	ulica
ulica Iłżecka	ulica
ulica Imbirowa	ulica
ulica Imielińska	ulica
ulica Improwizacji	ulica
ulica Indiry Gandhi	ulica
ulica Indycza	ulica
ulica Indyjska	ulica
ulica Inflancka	ulica
ulica Inna	ulica
ulica Inowłodzka	ulica
ulica Inowrocławska	ulica
ulica Inspektowa	ulica
ulica Instalatorów	ulica
ulica Instruktorska	ulica
ulica Insurekcji	ulica
ulica Internetowa	ulica
ulica Inżynierska	ulica
ulica Ireny Kosmowskiej	ulica
ulica Ireny	ulica
ulica Irlandzka	ulica
ulica Irminy	ulica
ulica Irydowa	ulica
ulica Irysowa	ulica
ulica Irysów	ulica
ulica Iskry	ulica
ulica IV Poprzeczna	ulica
ulica IV Poprzeczna	ulica
ulica Iwicka	ulica
ulica Iwonicka	ulica
ulica IX Poprzeczna	ulica
ulica IX Poprzeczna	ulica
ulica Izaaka Newtona	ulica
ulica Izabelli	ulica
ulica Izbicka	ulica
ulica Izdebnicka	ulica
ulica Izerska	ulica
ulica Izoldy	ulica
ulica I Poprzeczna	ulica
ulica Jabłeczna	ulica
ulica Jabłoni	ulica
ulica Jachtowa	ulica
ulica Jacka i Agatki	ulica
ulica Jadowska	ulica
ulica Jadwigi Smosarskiej	ulica
ulica Jadwigi i Witolda Kokoszków	ulica
ulica Jadźwingów	ulica
ulica Jagiellońska	ulica
ulica Jagielska	ulica
ulica Jagienki	ulica
ulica Jagny	ulica
ulica Jagodowa	ulica
ulica Jagody	ulica
ulica Jakobinów	ulica
ulica Jaktorowska	ulica
ulica Jakubowska	ulica
ulica Jakuba Kubickiego	ulica
ulica Jakuba Mortkowicza	ulica
ulica Jałowcowa	ulica
ulica Jałtańska	ulica
ulica Jamesa Gordona Bennetta	ulica
ulica Jamesa Joyce'a	ulica
ulica Jamińska	ulica
ulica Jamki	ulica
ulica Jana i Jędrzeja Śniadeckich	ulica
ulica Janczarów	ulica
ulica Janka Bytnara „Rudego”	ulica
ulica Janka Krasickiego	ulica
ulica Janinówka	ulica
ulica Janiszowska	ulica
ulica Janka Muzykanta	ulica
ulica Jankowska	ulica
ulica Janosika	ulica
ulica Janowiecka	ulica
ulica Jantarowy Szlak	ulica
ulica Jantar	ulica
ulica Januszewska	ulica
ulica Janusza Groszkowskiego	ulica
ulica Janusza Korczaka	ulica
ulica Janusza Kusocińskiego	ulica
ulica Janusza Meissnera	ulica
ulica Jana Andrzeja Morsztyna	ulica
ulica Jana Blatona	ulica
ulica Jana Brzechwy	ulica
ulica Jana Bułhaka	ulica
ulica Jana Chryzostoma Paska	ulica
ulica Jana Cybisa	ulica
ulica Jana Czeczota	ulica
ulica Jana Feliksa Piwarskiego	ulica
ulica Jana Gawińskiego	ulica
ulica Jana Husa	ulica
ulica Jana Jeziorańskiego	ulica
ulica Jana Józefa Lipskiego	ulica
ulica Jana Kasprowicza	ulica
ulica Jana Kędzierskiego	ulica
ulica Jana Kiepury	ulica
ulica Jana Kilińskiego	ulica
ulica Jana Kochanowskiego	ulica
ulica Jana Kossakowskiego	ulica
ulica Jana Kozietulskiego	ulica
ulica Jana Krysta	ulica
ulica Jana Lechonia	ulica
ulica Jana Maklakiewicza	ulica
ulica Jana Marcina Szancera	ulica
ulica Jana Matejki	ulica
ulica Jana Miklaszewskiego	ulica
ulica Jana Mizerkiewicza	ulica
ulica Jana Młota	ulica
ulica Jana Nagórskiego	ulica
ulica Jana Nowaka-Jeziorańskiego	ulica
ulica Jana Ostroroga	ulica
ulica Jana Pankiewicza	ulica
ulica Jana Parandowskiego	ulica
ulica Jana Paszyna	ulica
ulica Jana Pawła II	ulica
ulica Jana Piekałkiewicza	ulica
ulica Jana Rosoła	ulica
ulica Jana Sebastiana Bacha	ulica
ulica Jana Sibeliusa	ulica
ulica Jana Styki	ulica
ulica Jana Szałka	ulica
ulica Jana Szczepanika	ulica
ulica Jana Szymczaka	ulica
ulica Jana Wasilkowskiego	ulica
ulica Jana Zamoyskiego	ulica
ulica Jana Zaorskiego	ulica
ulica Jana Żabińskiego	ulica
ulica Jana Żiżki	ulica
ulica Jarocińska	ulica
ulica Jarosławska	ulica
ulica Jara	ulica
ulica Jarząbków	ulica
ulica Jarzębinowa	ulica
ulica Jasielska	ulica
ulica Jasiniec	ulica
ulica Jaskółcza	ulica
ulica Jaskrów	ulica
ulica Jasnodworska	ulica
ulica Jasnoty	ulica
ulica Jasna	ulica
ulica Jasówka	ulica
ulica Jaspisowa	ulica
ulica Jastrzębia	ulica
ulica Jaszczurcza	ulica
ulica Jaszowiecka	ulica
ulica Jaśminowa	ulica
ulica Jawaharlala Nehru	ulica
ulica Jaworowska	ulica
ulica Jaworowa	ulica
ulica Jaworzniaków	ulica
ulica Jaworzyńska	ulica
ulica Jazdów	ulica
ulica Jazgarzewska	ulica
ulica XI Poprzeczna	ulica
ulica Jedlińska	ulica
ulica Jedwabnicka	ulica
ulica Jedwabnicza	ulica
ulica Jelenia	ulica
ulica Jeleniogórska	ulica
ulica Jemiołowa	ulica
ulica Jemiołuszki	ulica
ulica Jerzego	ulica
ulica Jerzego i Władysławy Włoczewskich	ulica
ulica Jerzyka	ulica
ulica Jerzego Bajana	ulica
ulica Jerzego Bukowskiego	ulica
ulica Jerzego Iwanowa-Szajnowicza	ulica
ulica Jerzego Kukuczki	ulica
ulica Jerzego Michałowicza	ulica
ulica Jerzego Sochackiego	ulica
ulica Jerzego Szaniawskiego	ulica
ulica Jerzego Zaruby	ulica
ulica Jesienna	ulica
ulica Jesiennych Liści	ulica
ulica Jesionowa	ulica
ulica Jesiotrowa	ulica
ulica Jeziorki	ulica
ulica Jeziorna	ulica
ulica Jeziorowa	ulica
ulica Jezuicka	ulica
ulica Jeździecka	ulica
ulica Jeża	ulica
ulica Jeżowa	ulica
ulica Jeżynowa	ulica
ulica Jodłowa	ulica
ulica Johna Lennona	ulica
ulica Jontka	ulica
ulica Jordanowska	ulica
ulica Josepha Conrada	ulica
ulica Jowisza	ulica
ulica Józefa i Jana Rostafińskich	ulica
ulica Józefowska	ulica
ulica Józefa Antalla	ulica
ulica Józefa Balcerzaka	ulica
ulica Józefa Bellottiego	ulica
ulica Józefa Brandta	ulica
ulica Józefa Chełmońskiego	ulica
ulica Józefa Chmiela	ulica
ulica Józefa Czechowicza	ulica
ulica Józefa Edwarda Abramowskiego	ulica
ulica Józefa Elsnera	ulica
ulica Józefa Feliksa Ciszewskiego	ulica
ulica Józefa Garibaldiego	ulica
ulica Józefa Ignacego Kraszewskiego	ulica
ulica Józefa Korzeniowskiego	ulica
ulica Józefa Lewartowskiego	ulica
ulica Józefa Marii Hoene-Wrońskiego	ulica
ulica Józefa Mehoffera	ulica
ulica Józefa Mianowskiego	ulica
ulica Józefa Mireckiego „Montwiłła”	ulica
ulica Józefa Nusbauma-Hilarowicza	ulica
ulica Józefa Siemieńskiego	ulica
ulica Józefa Sierakowskiego	ulica
ulica Józefa Strusia	ulica
ulica Józefa Supińskiego	ulica
ulica Józefa Szanajcy	ulica
ulica Józefa Szujskiego	ulica
ulica Józefa Szymańskiego	ulica
ulica Józefa Węgrzyna	ulica
ulica Józefa Wybickiego	ulica
ulica Józefa Zaliwskiego	ulica
ulica Jubilerska	ulica
ulica Jugosłowiańska	ulica
ulica Juhasów	ulica
ulica Julianowska	ulica
ulica Juliana Adolfa Święcickiego	ulica
ulica Juliana Bartoszewicza	ulica
ulica Juliana Bruna	ulica
ulica Juliana Ejsmonda	ulica
ulica Juliana Fałata	ulica
ulica Juliana Kulskiego	ulica
ulica Juliana Marchlewskiego	ulica
ulica Juliana Przybosia	ulica
ulica Juliana Smulikowskiego	ulica
ulica Juliana Tuwima	ulica
ulica Juliana Ursyna Niemcewicza	ulica
ulica Juliusza Fucika	ulica
ulica Juliusza Kadena-Bandrowskiego	ulica
ulica Juliusza Konstantego Ordona	ulica
ulica Juliusza Kossaka	ulica
ulica Juliusza Osterwy	ulica
ulica Juliusza Rydygiera	ulica
ulica Juliusza Słowackiego	ulica
ulica Junaków	ulica
ulica Juranda ze Spychowa	ulica
ulica Juraty	ulica
ulica Jurija Gagarina	ulica
ulica Justyny Budzińskiej-Tylickiej	ulica
ulica Jutrzenki	ulica
ulica Kabacka	ulica
ulica Kabacki Dukt	ulica
ulica Kabaretowa	ulica
ulica Kabrioletu	ulica
ulica Kacpra Karlińskiego	ulica
ulica Kaczeńca	ulica
ulica Kaczorowska	ulica
ulica Kacza	ulica
ulica Kaczy Dół	ulica
ulica Kadetów	ulica
ulica Kadrowa	ulica
ulica Kadryla	ulica
ulica Kaflowa	ulica
ulica Kajakowa	ulica
ulica Kajetana Garbińskiego	ulica
ulica Kajetana Koźmiana	ulica
ulica Kajetańska	ulica
ulica Kakaowa	ulica
ulica Kaktusowa	ulica
ulica Kalambur	ulica
ulica Kalatówki	ulica
ulica Kalendarzowa	ulica
ulica Kaleńska	ulica
ulica Kaletnicza	ulica
ulica Kalinowej Łąki	ulica
ulica Kalinowska	ulica
ulica Kalinowa	ulica
ulica Kaliny	ulica
ulica Kaliska	ulica
ulica Kaliszówka	ulica
ulica Kaloryczna	ulica
ulica Kałuszyńska	ulica
ulica Kamasznicza	ulica
ulica Kamedulska	ulica
ulica Kameliowa	ulica
ulica Kameralna	ulica
ulica Kamienne Schodki	ulica
ulica Kamienna	ulica
ulica Kamionkowska	ulica
ulica Kampinoska	ulica
ulica Kamykowa	ulica
ulica Kamyk	ulica
ulica Kanadyjska	ulica
ulica Kanałowa	ulica
ulica Kanarkowa	ulica
ulica Kaniowska	ulica
ulica Kanonia	ulica
ulica Kanonierska	ulica
ulica Kapelanów Armii Krajowej	ulica
ulica Kapelanów Armii Krajowej	ulica
ulica Kapelanów Armii Krajowej	ulica
ulica Kapeli	ulica
ulica Kapelusznicza	ulica
ulica Kapitana Władysława Raginisa	ulica
ulica Kapitańska	ulica
ulica Kapitulna	ulica
ulica Kaprys	ulica
ulica Kapucyńska	ulica
ulica Karabeli	ulica
ulica Karatowa	ulica
ulica Karczewska	ulica
ulica Karczocha	ulica
ulica Karczunkowska	ulica
ulica Kardynała Aleksandra Kakowskiego	ulica
ulica Kardynała Stanisława Hozjusza	ulica
ulica Karkonoska	ulica
ulica Karkonoszy	ulica
ulica Karla	ulica
ulica Karmazynowa	ulica
ulica Karmelicka	ulica
ulica Karminowa	ulica
ulica Karnawał	ulica
ulica Karnicka	ulica
ulica Karolinki	ulica
ulica Karolkowa	ulica
ulica Karolówka	ulica
ulica Karola Adamieckiego	ulica
ulica Karola Bohdanowicza	ulica
ulica Karola Borsuka	ulica
ulica Karola Darwina	ulica
ulica Karola Dickensa	ulica
ulica Karola Irzykowskiego	ulica
ulica Karola Kurpińskiego	ulica
ulica Karola Levittoux	ulica
ulica Karola Linneusza	ulica
ulica Karola Marcinkowskiego	ulica
ulica Karola Miarki	ulica
ulica Karola Szajnochy	ulica
ulica Karola Szczecińskiego	ulica
ulica Karola Szymanowskiego	ulica
ulica Karola Wójcika	ulica
ulica Karowa	ulica
ulica Karpacka	ulica
ulica Karska	ulica
ulica Kartaginy	ulica
ulica Kartezjusza	ulica
ulica Kartograficzna	ulica
ulica Kartonowa	ulica
ulica Karuzela	ulica
ulica Karwińska	ulica
ulica Kasjopei	ulica
ulica Kaskadowa	ulica
ulica Kaspijska	ulica
ulica Kaszmirowa	ulica
ulica Kasztanowa	ulica
ulica Kaszubska	ulica
ulica Kaśki Kariatydy	ulica
ulica Katalogowa	ulica
ulica Katalońska	ulica
ulica Katarynki	ulica
ulica Katiuszy	ulica
ulica Katowicka	ulica
ulica Kaukaska	ulica
ulica Kawalerii	ulica
ulica Kawcza	ulica
ulica Kawęczyńska	ulica
ulica Kazachska	ulica
ulica Kazimierzowska	ulica
ulica Kazimierza Brodzińskiego	ulica
ulica Kazimierza Cichowskiego	ulica
ulica Kazimierza Deyny	ulica
ulica Kazimierza Drewnowskiego	ulica
ulica Kazimierza Gierdziejewskiego	ulica
ulica Kazimierza Grodeckiego	ulica
ulica Kazimierza Jeżewskiego	ulica
ulica Kazimierza Karasia	ulica
ulica Kazimierza Króla	ulica
ulica Kazimierza Kuratowskiego	ulica
ulica Kazimierza Promyka	ulica
ulica Kazimierza Pużaka	ulica
ulica Kazimierza Siemienowicza	ulica
ulica Kazimierza Sotta „Sokoła”	ulica
ulica Kazimierza Szałasa	ulica
ulica Kazimierza Szpotańskiego	ulica
ulica Kazimierza Wierzyńskiego	ulica
ulica Kazimierza Wóycickiego	ulica
ulica Kazimierza Wyki	ulica
ulica Kazimierza Zarankiewicza	ulica
ulica Kazita	ulica
ulica Kazubów	ulica
ulica Kazuńska	ulica
ulica Kąkolewska	ulica
ulica Kąkolowa	ulica
ulica Kąpielowa	ulica
ulica Kąsek	ulica
ulica Kątna	ulica
ulica Kątowa	ulica
ulica Kąty Grodziskie	ulica
ulica Ketlinga	ulica
ulica Kędzierzyńska	ulica
ulica Kędziołeczki	ulica
ulica Kępa Tarchomińska	ulica
ulica Kępna	ulica
ulica Kibiców	ulica
ulica Kielecka	ulica
ulica Kiełpińska	ulica
ulica Kiermaszowa	ulica
ulica Kijowska	ulica
ulica Kinetyczna	ulica
ulica Kingi	ulica
ulica Kinowa	ulica
ulica Kiprów	ulica
ulica Kirasjerów	ulica
ulica Kircholmska	ulica
ulica Kisielicka	ulica
ulica Kiwerska	ulica
ulica Klamrowa	ulica
ulica Klarnecistów	ulica
ulica Klarysewska	ulica
ulica Klasyków	ulica
ulica Klasztorna	ulica
ulica Klaudyny	ulica
ulica Klecka	ulica
ulica Kleczewska	ulica
ulica Klembowska	ulica
ulica Klementowicka	ulica
ulica Klementyny Hoffmanowej	ulica
ulica Kleopatry	ulica
ulica Kleszczowa	ulica
ulica Klimatyczna	ulica
ulica Klimontowska	ulica
ulica Klonowa	ulica
ulica Klubowa	ulica
ulica Kluczborska	ulica
ulica Kluczowa	ulica
ulica Klukowska	ulica
ulica Kłobucka	ulica
ulica Kłodawska	ulica
ulica Kłodzka	ulica
ulica Kłopot	ulica
ulica Kłosowa	ulica
ulica Kmicica	ulica
ulica Kminkowa	ulica
ulica Kniei	ulica
ulica Knyszyńska	ulica
ulica Kobiałka	ulica
ulica Kobielska	ulica
ulica Kobierzycka	ulica
ulica Kobryńska	ulica
ulica Kobuza	ulica
ulica Kobylańska	ulica
ulica Kobzy	ulica
ulica Kociszewskich	ulica
ulica Kocka	ulica
ulica Kogucia	ulica
ulica Kokarda	ulica
ulica Kokoryczki	ulica
ulica Kokosowa	ulica
ulica Kolady	ulica
ulica Kolarska	ulica
ulica Kolbaczewska	ulica
ulica Kolegiacka	ulica
ulica Kolejarska	ulica
ulica Kolejowa	ulica
ulica Kolektorska	ulica
ulica Kolendrowa	ulica
ulica Kolibrów	ulica
ulica Kolista	ulica
ulica Kolneńska	ulica
ulica Kolorowa	ulica
ulica Kolska	ulica
ulica Kolumbijska	ulica
ulica Kołacińska	ulica
ulica Kołczana	ulica
ulica Kołobrzeska	ulica
ulica Kołodziejska	ulica
ulica Kołowa	ulica
ulica Kombajnistów	ulica
ulica Kominiarska	ulica
ulica Kominkowa	ulica
ulica Komorowska	ulica
ulica Komorska	ulica
ulica Kompanii Armii Krajowej „Kordian”	ulica
ulica Kompanii Armii Krajowej „Kordian”	ulica
ulica Kompasowa	ulica
ulica Komputerowa	ulica
ulica Komunardów	ulica
ulica Koncertowa	ulica
ulica Kondracka	ulica
ulica Konduktorska	ulica
ulica Konewki	ulica
ulica Koniczynowa	ulica
ulica Koniecpolska	ulica
ulica Konińska	ulica
ulica Konopacka	ulica
ulica Konopna	ulica
ulica Konotopska	ulica
ulica Konrada Guderskiego	ulica
ulica Konstancińska	ulica
ulica Konstantego Ciołkowskiego	ulica
ulica Konstantego Ildefonsa Gałczyńskiego	ulica
ulica Konstruktorska	ulica
ulica Konturowa	ulica
ulica Kontuszowa	ulica
ulica Konwaliowa	ulica
ulica Konwiktorska	ulica
ulica Konwisarska	ulica
ulica Koński Jar	ulica
ulica Kopalniana	ulica
ulica Kopijników	ulica
ulica Kopińska	ulica
ulica Koprowa	ulica
ulica Koprzywiańska	ulica
ulica Koralowa	ulica
ulica Korczyńska	ulica
ulica Kordiana	ulica
ulica Koreańska	ulica
ulica Korkowa	ulica
ulica Kormoranów	ulica
ulica Kornela Makuszyńskiego	ulica
ulica Koronacyjna	ulica
ulica Koronowska	ulica
ulica Korowodu	ulica
ulica Korsarska	ulica
ulica Korsuńska	ulica
ulica Korsykańska	ulica
ulica Koryncka	ulica
ulica Korytnicka	ulica
ulica Korzeniowa	ulica
ulica Korzenna	ulica
ulica Korzystna	ulica
ulica Kosaćcowa	ulica
ulica Kosiarzy	ulica
ulica Kosmatki	ulica
ulica Kosmosu	ulica
ulica Kosobudzka	ulica
ulica Kosodrzewiny	ulica
ulica Kostrzyńska	ulica
ulica Kosynierów	ulica
ulica Koszalińska	ulica
ulica Koszęcińska	ulica
ulica Koszycka	ulica
ulica Koszykarska	ulica
ulica Koszykowa	ulica
ulica Kośby	ulica
ulica Kościańska	ulica
ulica Kościeliska	ulica
ulica Kościelna	ulica
ulica Kościerska	ulica
ulica Kościeszów	ulica
ulica Kościuszkowców	ulica
ulica Kotlarska	ulica
ulica Kotwiczna	ulica
ulica Kotylion	ulica
ulica Kowarska	ulica
ulica Kowelska	ulica
ulica Kowieńska	ulica
ulica Kozia	ulica
ulica Kozia Górka	ulica
ulica Kozielska	ulica
ulica Koziorożca	ulica
ulica Kozłowicka	ulica
ulica Koźlaków	ulica
ulica Koźla	ulica
ulica Koźmińska	ulica
ulica Kożuchowska	ulica
ulica Kórnicka	ulica
ulica Krajeńska	ulica
ulica Krajowej Rady Narodowej	ulica
ulica Krakowiaków	ulica
ulica Krakowskie Przedmieście	ulica
ulica Krakusa	ulica
ulica Kramarska	ulica
ulica Krańcowa	ulica
ulica Krasiczyńska	ulica
ulica Kraski	ulica
ulica Krasnobrodzka	ulica
ulica Krasnoludków	ulica
ulica Krasnołęcka	ulica
ulica Krasnowolska	ulica
ulica Kraśnicka	ulica
ulica Krawiecka	ulica
ulica Krechowiecka	ulica
ulica Kredytowa	ulica
ulica Kremowa	ulica
ulica Kresowa	ulica
ulica Kretonowa	ulica
ulica Kręta	ulica
ulica Krobińska	ulica
ulica Krochmalna	ulica
ulica Kroczewska	ulica
ulica Krokusów	ulica
ulica Krokwi	ulica
ulica Kronikarska	ulica
ulica Krośniewicka	ulica
ulica Krotoszyńska	ulica
ulica Krowia	ulica
ulica Króla Artura	ulica
ulica Króla Maciusia	ulica
ulica Królewicza Aleksandra	ulica
ulica Królewicza Jakuba	ulica
ulica Królewska	ulica
ulica Królowej Anny Jagiellonki	ulica
ulica Królowej Barbary Radziwiłłówny	ulica
ulica Królowej Bony Sforzy	ulica
ulica Królowej Elżbiety Rakuszanki	ulica
ulica Królowej Marii Kazimiery	ulica
ulica Królowej Marii Ludwiki Gonzagi	ulica
ulica Królowej Aldony	ulica
ulica Królowej Jadwigi	ulica
ulica Królowej Marysieńki	ulica
ulica Królów Polskich	ulica
ulica Króla Bolesława II Śmiałego	ulica
ulica Króla Bolesława I Chrobrego	ulica
ulica Króla Jana III Sobieskiego	ulica
ulica Króla Jana II Kazimierza	ulica
ulica Króla Jana I Olbrachta	ulica
ulica Króla Kazimierza III Wielkiego	ulica
ulica Króla Kazimierza IV Jagiellończyka	ulica
ulica Króla Przemysława II	ulica
ulica Króla Stanisława Leszczyńskiego	ulica
ulica Króla Stefana Batorego	ulica
ulica Króla Władysława III Warneńczyka	ulica
ulica Króla Władysława II Jagiełły	ulica
ulica Króla Władysława IV Wazy	ulica
ulica Króla Zygmunta III Wazy	ulica
ulica Króla Zygmunta II Augusta	ulica
ulica Krótka	ulica
ulica Króżańska	ulica
ulica Krucza	ulica
ulica Krupnicza	ulica
ulica Kruszwicka	ulica
ulica Kruszyny	ulica
ulica Kruszyńska	ulica
ulica Krymska	ulica
ulica Kryniczna	ulica
ulica Krynoliny	ulica
ulica Krypska	ulica
ulica Krystyny Matysiakówny	ulica
ulica Kryształowa	ulica
ulica Krzesanego	ulica
ulica Krzesiwa	ulica
ulica Krzewna	ulica
ulica Krzysztofa Kamila Baczyńskiego	ulica
ulica Krzysztofa Kiersnowskiego	ulica
ulica Krzysztofa Kieślowskiego	ulica
ulica Krzysztofa Klenczona	ulica
ulica Krzysztofa Kolumba	ulica
ulica Krzysztofa Komedy	ulica
ulica Krzysztofa Opalińskiego	ulica
ulica Krzysztofa Warszewickiego	ulica
ulica Krzywe Koło	ulica
ulica Krzywińska	ulica
ulica Krzywopoboczna	ulica
ulica Krzywa	ulica
ulica Krzyżówki	ulica
ulica Ksawerów	ulica
ulica Ksawerego Bronikowskiego	ulica
ulica Ksawerego Pruszyńskiego	ulica
ulica Księdza Antoniego Mackiewicza	ulica
ulica Księdza Bronisława Markiewicza	ulica
ulica Księdza Gabriela Piotra Boduena	ulica
ulica Księdza Grzegorza Piramowicza	ulica
ulica Księdza Ignacego Jana Skorupki	ulica
ulica Księdza Ignacego Kłopotowskiego	ulica
ulica Księdza Jana Brożka	ulica
ulica Księdza Jana Sitnika	ulica
ulica Księdza Jana Sztuki	ulica
ulica Księdza Jerzego Popiełuszki	ulica
ulica Księdza Juliana Chrościckiego	ulica
ulica Księdza Kazimierza Czarkowskiego	ulica
ulica Księdza Piotra Skargi	ulica
ulica Księdza Piotra Ściegiennego	ulica
ulica Księdza Prymasa Augusta Hlonda	ulica
ulica Księdza Stanisława Orzechowskiego	ulica
ulica Księdza Stanisława Skrzeszewskiego	ulica
ulica Księdza Sylwestra Szulczyka	ulica
ulica Księdza Teofila Boguckiego	ulica
ulica Księdza Zygmunta Trószyńskiego	ulica
ulica Książęca	ulica
ulica Księcia Bolesława III Krzywoustego	ulica
ulica Księcia Henryka II Pobożnego	ulica
ulica Księcia Henryka IV Probusa	ulica
ulica Księcia Henryka I Brodatego	ulica
ulica Księcia Janusza I	ulica
ulica Księcia Kazimierza II Sprawiedliwego	ulica
ulica Księcia Kazimierza I Odnowiciela	ulica
ulica Księcia Leszka Białego	ulica
ulica Księcia Leszka Czarnego	ulica
ulica Księcia Mieszka III Starego	ulica
ulica Księcia Mieszka I	ulica
ulica Księcia Władysława Hermana	ulica
ulica Księcia Władysława III Laskonogiego	ulica
ulica Księcia Władysława I Łokietka	ulica
ulica Książkowa	ulica
ulica Księcia Bolesława	ulica
ulica Księcia Kiejstuta	ulica
ulica Księcia Olgierda	ulica
ulica Księcia Trojdena	ulica
ulica Księcia Witolda	ulica
ulica Księcia Ziemowita	ulica
ulica Księgarzy	ulica
ulica Księżnej Anny	ulica
ulica Księżnej Biruty	ulica
ulica Księżycowa	ulica
ulica Kubańska	ulica
ulica Kubusia Puchatka	ulica
ulica Kudowska	ulica
ulica Kuflewska	ulica
ulica Kuglarska	ulica
ulica Kujawska	ulica
ulica Kukiełki	ulica
ulica Kukułki	ulica
ulica Kulczycka	ulica
ulica Kuligowska	ulica
ulica Kuniecka	ulica
ulica Kuny	ulica
ulica Kuracyjna	ulica
ulica Kurantów	ulica
ulica Kurhan	ulica
ulica Kurkowa	ulica
ulica Kuropatwy	ulica
ulica Kurpiowska	ulica
ulica Kurzawska	ulica
ulica Kuszników	ulica
ulica Kutnowska	ulica
ulica Kuźnicy Kołłątajowskiej	ulica
ulica Ku Wiśle	ulica
ulica Kwarciana	ulica
ulica Kwatery Głównej	ulica
ulica Kwiatowa	ulica
ulica Kwiatów Polskich	ulica
ulica Kwidzyńska	ulica
ulica Kwitnącego Sadu	ulica
ulica Kwitnącej Akacji	ulica
ulica Kwitnącej Łąki	ulica
ulica Kwitnącej Wiśni	ulica
ulica Kwitnąca	ulica
ulica Lajkonika	ulica
ulica Lajosa Kossutha	ulica
ulica Lakowa	ulica
ulica Lalki	ulica
ulica Lambady	ulica
ulica Landwarowska	ulica
ulica Lapońska	ulica
ulica Lasek Brzozowy	ulica
ulica Laserowa	ulica
ulica Laskowa	ulica
ulica Latarnika	ulica
ulica Latoszki	ulica
ulica Latyczowska	ulica
ulica Laurowa	ulica
ulica Lawendowa	ulica
ulica Lawendy	ulica
ulica Lawinowa	ulica
ulica Lazurowa	ulica
ulica Lądowa	ulica
ulica Lebiodowa	ulica
ulica Lecha	ulica
ulica Lechicka	ulica
ulica Lechitów	ulica
ulica Legendy	ulica
ulica Legionowa	ulica
ulica Legnicka	ulica
ulica Lekarska	ulica
ulica Lektykarska	ulica
ulica Lelechowska	ulica
ulica Leliwitów	ulica
ulica Lelka	ulica
ulica Lemiesz	ulica
ulica Leonarda	ulica
ulica Leonarda Buczkowskiego	ulica
ulica Leonidasa	ulica
ulica Leonida Teligi	ulica
ulica Leona Berensona	ulica
ulica Leona Idzikowskiego	ulica
ulica Leona Kruczkowskiego	ulica
ulica Leona Schillera	ulica
ulica Leona Wyczółkowskiego	ulica
ulica Leopolda Lisa-Kuli	ulica
ulica Leopolda Staffa	ulica
ulica Leszczynowa	ulica
ulica Leszczyny	ulica
ulica Leszczyńska	ulica
ulica Leszno	ulica
ulica Lesznowolska	ulica
ulica Leszowa	ulica
ulica Leśnej Polanki	ulica
ulica Leśniczówka	ulica
ulica Leśniewska	ulica
ulica Leśna	ulica
ulica Leśnych Ziół	ulica
ulica Leśny Potok	ulica
ulica Letnia	ulica
ulica Letniskowa	ulica
ulica Lewandów	ulica
ulica Lewicka	ulica
ulica Lewicpolska	ulica
ulica Lewinowska	ulica
ulica Lewkonii	ulica
ulica Lwa Tołstoja	ulica
ulica Leżajska	ulica
ulica Leżakowa	ulica
ulica Lęborska	ulica
ulica Lędzka	ulica
ulica Libawska	ulica
ulica Libijska	ulica
ulica Licealna	ulica
ulica Liczydło	ulica
ulica Lidzbarska	ulica
ulica Lidzka	ulica
ulica Ligocka	ulica
ulica Ligustrowa	ulica
ulica Limby	ulica
ulica Linotypowa	ulica
ulica Lipiec Reymontowskich	ulica
ulica Lipińska	ulica
ulica Lipkowska	ulica
ulica Lipowa	ulica
ulica Lipska	ulica
ulica Liptowska	ulica
ulica Lirowa	ulica
ulica Liryczna	ulica
ulica Lisia	ulica
ulica Lisi Jar	ulica
ulica Lisowska	ulica
ulica Listonoszy	ulica
ulica Listopadowa	ulica
ulica Liściasta	ulica
ulica Liścienia	ulica
ulica Litawora	ulica
ulica Literacka	ulica
ulica Literatów	ulica
ulica Litewska	ulica
ulica Litworowa	ulica
ulica Liwiecka	ulica
ulica Liwska	ulica
ulica Lizbońska	ulica
ulica Lniana	ulica
ulica Lokalna	ulica
ulica Londyńska	ulica
ulica Lotaryńska	ulica
ulica Loteryjki	ulica
ulica Lotnicza	ulica
ulica Lotnika	ulica
ulica Lotosu	ulica
ulica Lubartowska	ulica
ulica Lubaszki	ulica
ulica Lubczyka	ulica
ulica Lubelska	ulica
ulica Lubiana	ulica
ulica Lubieszowska	ulica
ulica Lubiniecka	ulica
ulica Lubkowska	ulica
ulica Lubomelska	ulica
ulica Lubomira	ulica
ulica Lubuska	ulica
ulica Lucerny	ulica
ulica Lucjana Rudnickiego	ulica
ulica Lucjana Rydla	ulica
ulica Lucyny Messal	ulica
ulica Lucynowska	ulica
ulica Ludna	ulica
ulica Ludomira Różyckiego	ulica
ulica Ludowa	ulica
ulica Ludwicka	ulica
ulica Ludwiki Wawrzyńskiej	ulica
ulica Ludwiki	ulica
ulica Ludwika Hirszfelda	ulica
ulica Ludwika Idzikowskiego	ulica
ulica Ludwika Kondratowicza	ulica
ulica Ludwika Krzywickiego	ulica
ulica Ludwika Mycielskiego	ulica
ulica Ludwika Nabielaka	ulica
ulica Ludwika Narbutta	ulica
ulica Ludwika Pasteura	ulica
ulica Ludwika Paszkiewicza	ulica
ulica Ludwika Rydygiera	ulica
ulica Ludwika Solskiego	ulica
ulica Ludwika van Beethovena	ulica
ulica Ludwika Waryńskiego	ulica
ulica Ludwika Zamenhofa	ulica
ulica Ludwinowska	ulica
ulica Ludwisarska	ulica
ulica Lusińska	ulica
ulica Lustrzana	ulica
ulica Lutniowa	ulica
ulica Lutocińska	ulica
ulica Lwa	ulica
ulica Lwowska	ulica
ulica Łabędzia	ulica
ulica Łabiszyńska	ulica
ulica Łacińska	ulica
ulica Ładna	ulica
ulica Łagiewnicka	ulica
ulica Łagodna	ulica
ulica Łagowska	ulica
ulica Łamana	ulica
ulica Łanowa	ulica
ulica Łany	ulica
ulica Łańcucka	ulica
ulica Łasicy	ulica
ulica Łasińska	ulica
ulica Ławnicza	ulica
ulica Łazanowicka	ulica
ulica Łaziebna	ulica
ulica Łazienkowska	ulica
ulica Łazy	ulica
ulica Łączna	ulica
ulica Łączyny	ulica
ulica Łąkocińska	ulica
ulica Łąkowa	ulica
ulica Łęczycka	ulica
ulica Łęgi	ulica
ulica Łobeska	ulica
ulica Łochowska	ulica
ulica Łodygowa	ulica
ulica Łojewska	ulica
ulica Łokciowa	ulica
ulica Łomiańska	ulica
ulica Łomżyńska	ulica
ulica Łopianowa	ulica
ulica Łopuszańska	ulica
ulica Łosia	ulica
ulica Łosicka	ulica
ulica Łososiowa	ulica
ulica Łotewska	ulica
ulica Łowcza	ulica
ulica Łowicka	ulica
ulica Łozinowa	ulica
ulica Łubinowa	ulica
ulica Łucka	ulica
ulica Łuczek	ulica
ulica Łucznicza	ulica
ulica Łuczywo	ulica
ulica Ługi	ulica
ulica Łukasza Drewny	ulica
ulica Łukasza Gołębiowskiego	ulica
ulica Łukasza Górnickiego	ulica
ulica Łukiska	ulica
ulica Łuki Małe	ulica
ulica Łuki Wielkie	ulica
ulica Łukowska	ulica
ulica Łukowa	ulica
ulica Łużycka	ulica
ulica Łysakowska	ulica
ulica Łysogórska	ulica
ulica Łyszkowicka	ulica
ulica Łyżwiarska	ulica
ulica Macedońska	ulica
ulica Maciejki	ulica
ulica Maciejowicka	ulica
ulica Macieja Kamieńskiego	ulica
ulica Macieja Rataja	ulica
ulica Macieja Sarbiewskiego	ulica
ulica Macierzanki	ulica
ulica Maćka z Bogdańca	ulica
ulica Madziarów	ulica
ulica Magazynowa	ulica
ulica Magenta	ulica
ulica Magistracka	ulica
ulica Magnacka	ulica
ulica Magnolii	ulica
ulica Magury	ulica
ulica Mahatmy Gandhiego	ulica
ulica Mahoniowa	ulica
ulica Majdańska	ulica
ulica Majerankowa	ulica
ulica Majolikowa	ulica
ulica Majorki	ulica
ulica Majora Franciszka Michała Amałowicza „Tatara”	ulica
ulica Majora Henryka Dobrzańskiego „Hubala”	ulica
ulica Majowa	ulica
ulica Makolągwy	ulica
ulica Makowska	ulica
ulica Maksymiliana Tytusa Hubera	ulica
ulica Malachitowa	ulica
ulica Malborska	ulica
ulica Malczycka	ulica
ulica Malinowa	ulica
ulica Malownicza	ulica
ulica Maltańska	ulica
ulica Maluchów	ulica
ulica Malwowa	ulica
ulica Malwy	ulica
ulica Małego Franka	ulica
ulica Małego Księcia	ulica
ulica Małego Rycerza	ulica
ulica Małej Brzozy	ulica
ulica Małej Łąki	ulica
ulica Małgorzaty Fornalskiej	ulica
ulica Małogoska	ulica
ulica Małowiejska	ulica
ulica Mała	ulica
ulica Małych Dębów	ulica
ulica Mandarynki	ulica
ulica Mangalia	ulica
ulica Mańkowska	ulica
ulica Marabuta	ulica
ulica Maratońska	ulica
ulica Marcelińska	ulica
ulica Marcelego Nowotki	ulica
ulica Marcella Bacciarellego	ulica
ulica Marchołta	ulica
ulica Marcina z Wrocimowic	ulica
ulica Marcina Bielskiego	ulica
ulica Marcina Flisa	ulica
ulica Marcina Kasprzaka	ulica
ulica Marcina Poczobutta-Odlanickiego	ulica
ulica Marconich	ulica
ulica Marco Polo	ulica
ulica Marecka	ulica
ulica Marka Hłaski	ulica
ulica Margerytki	ulica
ulica Mariana Buczka	ulica
ulica Mariana Falskiego	ulica
ulica Mariana Keniga	ulica
ulica Mariana Krawczyka	ulica
ulica Mariana Lalewicza	ulica
ulica Mariana Nowickiego	ulica
ulica Mariana Pisarka	ulica
ulica Mariana Rejewskiego	ulica
ulica Mariana Sengera „Cichego”	ulica
ulica Mariana Smoluchowskiego	ulica
ulica Mariańska	ulica
ulica Marii Bohuszewiczówny	ulica
ulica Marii Dąbrowskiej	ulica
ulica Marii Grzegorzewskiej	ulica
ulica Marii Konopnickiej	ulica
ulica Marii Pawlikowskiej-Jasnorzewskiej	ulica
ulica Marii Rodziewiczówny	ulica
ulica Marii Skłodowskiej-Curie	ulica
ulica Marii Wysłouchowej	ulica
ulica Mariensztat	ulica
ulica Markietanki	ulica
ulica Markowska	ulica
ulica Marmurowa	ulica
ulica Marokańska	ulica
ulica Marsa	ulica
ulica Marsylska	ulica
ulica Marszałkowska	ulica
ulica Marty	ulica
ulica Maryli	ulica
ulica Marymoncka	ulica
ulica Marynarska	ulica
ulica Marynin	ulica
ulica Marysińska	ulica
ulica Marywilska	ulica
ulica Marzanny	ulica
ulica Masłowiecka	ulica
ulica Maszewska	ulica
ulica Masztalerska	ulica
ulica Masztowa	ulica
ulica Maszynowa	ulica
ulica Maślaków	ulica
ulica Matecznik	ulica
ulica Matematyczna	ulica
ulica Materii	ulica
ulica Matuszewska	ulica
ulica Matyldy	ulica
ulica Maurycego Mochnackiego	ulica
ulica Mazowiecka	ulica
ulica Mazura	ulica
ulica Mazurska	ulica
ulica Mątwicka	ulica
ulica Mchów	ulica
ulica Meander	ulica
ulica Mechaników	ulica
ulica Meksykańska	ulica
ulica Melchiora Wańkowicza	ulica
ulica Melioracyjna	ulica
ulica Melisy	ulica
ulica Melodyjna	ulica
ulica Melomanów	ulica
ulica Melsztyńska	ulica
ulica Menueta	ulica
ulica Mestwina	ulica
ulica Mesyńska	ulica
ulica Metafory	ulica
ulica Metalowców	ulica
ulica Metryczna	ulica
ulica Metrykantów	ulica
ulica Męcińska	ulica
ulica Mglista	ulica
ulica Miączyńska	ulica
ulica Michalinki	ulica
ulica Michaliny	ulica
ulica Michałowska	ulica
ulica Michała Bałuckiego	ulica
ulica Michała Drzymały	ulica
ulica Michała Elwira Andriollego	ulica
ulica Michała Faradaya	ulica
ulica Michała Kajki	ulica
ulica Michała Kleofasa Ogińskiego	ulica
ulica Michała Oczapowskiego	ulica
ulica Michała Okurzałego	ulica
ulica Michała Ossowskiego	ulica
ulica Michała Rosnowskiego	ulica
ulica Michała Sobczaka	ulica
ulica Michała Spisaka	ulica
ulica Miechowska	ulica
ulica Mieczysława Fersta	ulica
ulica Mieczysława Frenkla	ulica
ulica Mieczysława Heymana	ulica
ulica Mieczysława Karłowicza	ulica
ulica Mieczysława Niedziałkowskiego	ulica
ulica Mieczysława Niedzielskiego „Żywiciela”	ulica
ulica Mieczysława Orłowicza	ulica
ulica Mieczysława Pawlikowskiego	ulica
ulica Mieczysława Pożaryskiego	ulica
ulica Mieczysława Szczuki	ulica
ulica Mieczysława Wolfkego	ulica
ulica Miedzianogórska	ulica
ulica Miedziana	ulica
ulica Miejska	ulica
ulica Mielecka	ulica
ulica Mielnicka	ulica
ulica Mieszczańska	ulica
ulica Międzyborska	ulica
ulica Międzynarodowa	ulica
ulica Międzyparkowa	ulica
ulica Międzyrzecka	ulica
ulica Miętowa	ulica
ulica Migdałowa	ulica
ulica Mikołaja z Długolasu	ulica
ulica Mikołajska	ulica
ulica Mikołaja Drygały	ulica
ulica Mikołaja Gomółki	ulica
ulica Mikołaja Kopernika	ulica
ulica Mikołaja Reja	ulica
ulica Mikołaja Sępa-Szarzyńskiego	ulica
ulica Mikołaja Wierzynka	ulica
ulica Milanowska	ulica
ulica Milana Rastislava Stefanika	ulica
ulica Milenijna	ulica
ulica Milewska	ulica
ulica Miłobędzka	ulica
ulica Miła	ulica
ulica Mimozy	ulica
ulica Mineralna	ulica
ulica Minerska	ulica
ulica Minutowa	ulica
ulica Mińska	ulica
ulica Miodowa	ulica
ulica Mirabelki	ulica
ulica Mirocińska	ulica
ulica Mirska	ulica
ulica Mirtowa	ulica
ulica Misia Uszatka	ulica
ulica Mistrzowska	ulica
ulica Mlądzka	ulica
ulica Mleczna	ulica
ulica Mławska	ulica
ulica Młocarni	ulica
ulica Młocińska	ulica
ulica Młodnicka	ulica
ulica Młoda	ulica
ulica Młodzieńcza	ulica
ulica Młodzieży	ulica
ulica Młynarska	ulica
ulica Młyńska	ulica
ulica Mniszka	ulica
ulica Mochtyńska	ulica
ulica Moczydło	ulica
ulica Moczydłowska	ulica
ulica Modelowa	ulica
ulica Modlińska	ulica
ulica Modraszki	ulica
ulica Modra	ulica
ulica Modrzewiowa	ulica
ulica Modrzykowa	ulica
ulica Modularna	ulica
ulica Mokotowska	ulica
ulica Mokra	ulica
ulica Mokry Ług	ulica
ulica Mokrzecka	ulica
ulica Moliera	ulica
ulica Mołdawska	ulica
ulica Montażowa	ulica
ulica Monte Cassino	ulica
ulica Morąska	ulica
ulica Mordechaja Anielewicza	ulica
ulica Morelowa	ulica
ulica Morgowa	ulica
ulica Morska	ulica
ulica Morskie Oko	ulica
ulica Morszyńska	ulica
ulica Morwowa	ulica
ulica Mory	ulica
ulica Mosiężna	ulica
ulica Mostowa	ulica
ulica Moszczenicka	ulica
ulica Motorowa	ulica
ulica Motycka	ulica
ulica Motylkowa	ulica
ulica Mozaikowa	ulica
ulica Moździerzy	ulica
ulica Mrągowska	ulica
ulica Mroczna	ulica
ulica Mrozowska	ulica
ulica Mroźna	ulica
ulica Mrówcza	ulica
ulica Mszańska	ulica
ulica Mszczonowska	ulica
ulica Mścisławska	ulica
ulica Muchomora	ulica
ulica Municypalna	ulica
ulica Muranowska	ulica
ulica Murarska	ulica
ulica Murawy	ulica
ulica Murmańska	ulica
ulica Muszkieterów	ulica
ulica Muszlowa	ulica
ulica Muszyńska	ulica
ulica Muzealna	ulica
ulica Muzyczna	ulica
ulica Mydlarska	ulica
ulica Mysia	ulica
ulica Mysikrólika	ulica
ulica Mysłowicka	ulica
ulica Myszkowska	ulica
ulica Myszyniecka	ulica
ulica Myśliborska	ulica
ulica Myśliwiecka	ulica
ulica Myśliwska	ulica
ulica Nachyłkowa	ulica
ulica Naczelnikowska	ulica
ulica Nadarzyńska	ulica
ulica Naddnieprzańska	ulica
ulica Nadieżdy Krupskiej	ulica
ulica Nadrzeczna	ulica
ulica Nadwiślańska	ulica
ulica Nadziei	ulica
ulica Nad Potokiem	ulica
ulica Nad Strugą	ulica
ulica Nad Wilanówką	ulica
ulica Nad Wisłą	ulica
ulica Naftalego Botwina	ulica
ulica Naftowa	ulica
ulica Nagietkowa	ulica
ulica Nagłowicka	ulica
ulica Nagodziców	ulica
ulica Nakielska	ulica
ulica Nalewki	ulica
ulica Nałęczowska	ulica
ulica Nałęcz	ulica
ulica Namioty	ulica
ulica Namysłowska	ulica
ulica Napoleona Bonaparte	ulica
ulica Naprzełaj	ulica
ulica Narcyzowa	ulica
ulica Narocz	ulica
ulica Narodowa	ulica
ulica Narożna	ulica
ulica Narwiańska	ulica
ulica Narwik	ulica
ulica Nasielska	ulica
ulica Nasienna	ulica
ulica Nastawnicza	ulica
ulica Nastrojowa	ulica
ulica Nasturcjowa	ulica
ulica Nasypowa	ulica
ulica Nasza	ulica
ulica Natalii Gąsiorowskiej-Grabowskiej	ulica
ulica Natalii	ulica
ulica Natolińska	ulica
ulica Nauczycielska	ulica
ulica Naukowa	ulica
ulica Nawigatorów	ulica
ulica Nawłocka	ulica
ulica Na Bateryjce	ulica
ulica Na Krańcu	ulica
ulica Na Przyzbie	ulica
ulica Na Skraju	ulica
ulica Na Uboczu	ulica
ulica Na Wyraju	ulica
ulica Nefrytowa	ulica
ulica Nenufarów	ulica
ulica Neseberska	ulica
ulica Newelska	ulica
ulica Niccola Paganiniego	ulica
ulica Nicejska	ulica
ulica Niebieska	ulica
ulica Nieborowska	ulica
ulica Niecała	ulica
ulica Niedotrzymska	ulica
ulica Nieduża	ulica
ulica Niedzielna	ulica
ulica Niedźwiedzia	ulica
ulica Niegocińska	ulica
ulica Niekłańska	ulica
ulica Niemeńska	ulica
ulica Niemirowska	ulica
ulica Niemodlińska	ulica
ulica Niepołomicka	ulica
ulica Nieporęcka	ulica
ulica Niesulicka	ulica
ulica Nieszawska	ulica
ulica Nieświeska	ulica
ulica Niewielka	ulica
ulica Niezapominajki	ulica
ulica Nike	ulica
ulica Niska	ulica
ulica Nizinna	ulica
ulica Nokturnu	ulica
ulica Norberta Barlickiego	ulica
ulica Notarialna	ulica
ulica Notecka	ulica
ulica Nowej Huty	ulica
ulica Nowiniarska	ulica
ulica Nowiny	ulica
ulica Nowińska	ulica
ulica Nowoberestecka	ulica
ulica Nowoczesna	ulica
ulica Nowodworska	ulica
ulica Nowogrodzka	ulica
ulica Nowolipie	ulica
ulica Nowolipki	ulica
ulica Nowomiejska	ulica
ulica Noworegulska	ulica
ulica Nowosądecka	ulica
ulica Nowosielecka	ulica
ulica Nowosolipsowska	ulica
ulica Nowotarska	ulica
ulica Nowotyska	ulica
ulica Nowoursynowska	ulica
ulica Nowowiejska	ulica
ulica Nowowiśniowa	ulica
ulica Nowa	ulica
ulica Nowy Przejazd	ulica
ulica Nowy Służewiec	ulica
ulica Nowy Świat	ulica
ulica Nowy Zjazd	ulica
ulica Nubijska	ulica
ulica Nugat	ulica
ulica Nurska	ulica
ulica Nurzyńska	ulica
ulica Nutki	ulica
ulica Obarowska	ulica
ulica Oberka	ulica
ulica Obiegowa	ulica
ulica Objazdowa	ulica
ulica Oblęgorska	ulica
ulica Obornicka	ulica
ulica Obotrycka	ulica
ulica Obozowa	ulica
ulica Oboźna	ulica
ulica Obrazkowa	ulica
ulica Obrębowa	ulica
ulica Obrońców	ulica
ulica Obrońców Helu	ulica
ulica Obrońców Pokoju	ulica
ulica Obrońców Tobruku	ulica
ulica Obrzeżna	ulica
ulica Obserwatorów	ulica
ulica Obszarowa	ulica
ulica Obwodowa	ulica
ulica Obywatelska	ulica
ulica Ochocka	ulica
ulica Ochocza	ulica
ulica Oczary	ulica
ulica Oczeretu	ulica
ulica Odblask	ulica
ulica Odeska	ulica
ulica Odkryta	ulica
ulica Odległa	ulica
ulica Odlewnicza	ulica
ulica Odłogi	ulica
ulica Odolańska	ulica
ulica Odpoczynek	ulica
ulica Odrębna	ulica
ulica Odrodzenia	ulica
ulica Odrzykońska	ulica
ulica Odsieczy Wiednia	ulica
ulica Odysa	ulica
ulica Odysei	ulica
ulica Oficerska	ulica
ulica Ogólna	ulica
ulica Ogórkowa	ulica
ulica Ogrodnicza	ulica
ulica Ogrodników	ulica
ulica Ogrodowa	ulica
ulica Ogrody	ulica
ulica Ojca Aniceta	ulica
ulica Ojcowska	ulica
ulica Ojrzanowska	ulica
ulica Okaryny	ulica
ulica Okęcka	ulica
ulica Okienko	ulica
ulica Oknicka	ulica
ulica Okocimska	ulica
ulica Okoliczna	ulica
ulica Okolska	ulica
ulica Okopowa	ulica
ulica Okólnik	ulica
ulica Okrągła	ulica
ulica Okrąg	ulica
ulica Określona	ulica
ulica Okrętowa	ulica
ulica Okrężna	ulica
ulica Okrzeszyńska	ulica
ulica Oksywska	ulica
ulica Oktawii	ulica
ulica Okularowa	ulica
ulica Okuniewska	ulica
ulica Olchy	ulica
ulica Olczyska	ulica
ulica Oleandrów	ulica
ulica Olecka	ulica
ulica Oleńki	ulica
ulica Olesin	ulica
ulica Olesińska	ulica
ulica Olgi Boznańskiej	ulica
ulica Olimpijska	ulica
ulica Oliwkowa	ulica
ulica Oliwska	ulica
ulica Olkuska	ulica
ulica Olszewska	ulica
ulica Olszowa	ulica
ulica Olszynki Grochowskiej	ulica
ulica Olszynowa	ulica
ulica Oławska	ulica
ulica Ołówkowa	ulica
ulica Ołtarzewska	ulica
ulica Ołycka	ulica
ulica Omulewska	ulica
ulica Ondraszka	ulica
ulica Opaczewska	ulica
ulica Opalin	ulica
ulica Opalińska	ulica
ulica Opalowa	ulica
ulica Opatowska	ulica
ulica Operowa	ulica
ulica Opieńki	ulica
ulica Opinogórska	ulica
ulica Opłotek	ulica
ulica Opoczyńska	ulica
ulica Optyczna	ulica
ulica Optymistów	ulica
ulica Oraczy	ulica
ulica Orańska	ulica
ulica Orbity	ulica
ulica Orchidei	ulica
ulica Orchowiecka	ulica
ulica Orderu Uśmiechu	ulica
ulica Ordynacka	ulica
ulica Orężna	ulica
ulica Orfeusza	ulica
ulica Organistów	ulica
ulica Orląt Lwowskich	ulica
ulica Orlego Lotu	ulica
ulica Orla	ulica
ulica Orlich Gniazd	ulica
ulica Orlika	ulica
ulica Orłowska	ulica
ulica Orłów Piastowskich	ulica
ulica Ornak	ulica
ulica Ornecka	ulica
ulica Or-Ota	ulica
ulica Orszady	ulica
ulica Oryszewska	ulica
ulica Orzechowska	ulica
ulica Orzechowa	ulica
ulica Orzycka	ulica
ulica Osada Ojców	ulica
ulica Osadnicza	ulica
ulica Osiecka	ulica
ulica Osiedle	ulica
ulica Osiedlowa	ulica
ulica Osieki	ulica
ulica Osikowa	ulica
ulica Oskara Kolberga	ulica
ulica Oskara Langego	ulica
ulica Oskara Sosnowskiego	ulica
ulica Osmańska	ulica
ulica Osowiecka	ulica
ulica Osowska	ulica
ulica Ossolińskich	ulica
ulica Ostaszewska	ulica
ulica Ostoja	ulica
ulica Ostów	ulica
ulica Ostrobramska	ulica
ulica Ostrogi	ulica
ulica Ostrołęcka	ulica
ulica Ostrowiecka	ulica
ulica Ostródzka	ulica
ulica Ostróżki	ulica
ulica Ostra	ulica
ulica Ostrzycka	ulica
ulica Osuchowska	ulica
ulica Oszczepników	ulica
ulica Oszmiańska	ulica
ulica Oświatowa	ulica
ulica Otawska	ulica
ulica Otrębuska	ulica
ulica Otwarta	ulica
ulica Otwocka	ulica
ulica Owalna	ulica
ulica Owczarska	ulica
ulica Owocowa	ulica
ulica Owsiana	ulica
ulica Ożarowska	ulica
ulica VIII Poprzeczna	ulica
ulica Paava Nurmiego	ulica
ulica Pabianicka	ulica
ulica Pabla Nerudy	ulica
ulica Pabla Picassa	ulica
ulica Pachnąca	ulica
ulica Pacholęca	ulica
ulica Paczkowska	ulica
ulica Padewska	ulica
ulica Pajęcza	ulica
ulica Palestyńska	ulica
ulica Palisadowa	ulica
ulica Palmirska	ulica
ulica Palmowa	ulica
ulica Paluch	ulica
ulica Pála Telekiego	ulica
ulica Pałacowa	ulica
ulica Pałuków	ulica
ulica Pana Tadeusza	ulica
ulica Pandy	ulica
ulica Panieńska	ulica
ulica Panny	ulica
ulica Panny Wodnej	ulica
ulica Panoramiczna	ulica
ulica Panoramy	ulica
ulica Pańska	ulica
ulica Papierowa	ulica
ulica Papieska	ulica
ulica Papirusów	ulica
ulica Paprociowa	ulica
ulica Paproci	ulica
ulica Papuzia	ulica
ulica Parcelacyjna	ulica
ulica Parkingowa	ulica
ulica Parkowa	ulica
ulica Parnas	ulica
ulica Parowcowa	ulica
ulica Parowozowa	ulica
ulica Parterowa	ulica
ulica Partyzantów	ulica
ulica Paryska	ulica
ulica Pasażerska	ulica
ulica Pasieczna	ulica
ulica Pasłęcka	ulica
ulica Pastelowa	ulica
ulica Pasterska	ulica
ulica Pastewna	ulica
ulica Pastuszków	ulica
ulica Pasymska	ulica
ulica Paśników	ulica
ulica Patriotów	ulica
ulica Patrolowa	ulica
ulica Pawła Edmunda Strzeleckiego	ulica
ulica Pawła Findera	ulica
ulica Pawła Lipowczana	ulica
ulica Pawła Stellera	ulica
ulica Pawła Suzina	ulica
ulica Pawła Włodkowica	ulica
ulica Pawia	ulica
ulica Pawłowska	ulica
ulica Pejzażowa	ulica
ulica Pelargonii	ulica
ulica Pelikanów	ulica
ulica Pelplińska	ulica
ulica Penelopy	ulica
ulica Peonii	ulica
ulica Pergaminów	ulica
ulica Perkalowa	ulica
ulica Perkoza	ulica
ulica Perkuna	ulica
ulica Perkusyjna	ulica
ulica Perlicza	ulica
ulica Perlonowa	ulica
ulica Perłowa	ulica
ulica Perseusza	ulica
ulica Perzowa	ulica
ulica Peszteńska	ulica
ulica Petunii	ulica
ulica Petyhorska	ulica
ulica Pęcherska	ulica
ulica Pęcicka	ulica
ulica Pianistów	ulica
ulica Piaseczyńska	ulica
ulica Piaskowa	ulica
ulica Piasta Kołodzieja	ulica
ulica Piastowska	ulica
ulica Piastowa	ulica
ulica Piastów Śląskich	ulica
ulica Piątkowska	ulica
ulica V Poprzeczna	ulica
ulica Piechocka	ulica
ulica Piechoty Łanowej	ulica
ulica Piechoty Wybranieckiej	ulica
ulica Piechurów	ulica
ulica Piecuszka	ulica
ulica Piekarska	ulica
ulica Pielęgniarek	ulica
ulica Pielgrzymów	ulica
ulica Pierwiosnków	ulica
ulica I Poprzeczna	ulica
ulica Piesza	ulica
ulica Pięciolinii	ulica
ulica Pięciu Stawów	ulica
ulica Piękna	ulica
ulica Pilarzy	ulica
ulica Pilchowicka	ulica
ulica Pilicka	ulica
ulica Piłkarska	ulica
ulica Pińczowska	ulica
ulica Pińska	ulica
ulica Piołunowa	ulica
ulica Pionierów	ulica
ulica Pionierska	ulica
ulica Piotrkowska	ulica
ulica Piotrusia Pana	ulica
ulica Piotra Antoniego Steinkellera	ulica
ulica Piotra Bardowskiego	ulica
ulica Piotra Gruszczyńskiego	ulica
ulica Piotra Kupidłowskiego	ulica
ulica Piotra Maszyńskiego	ulica
ulica Piotra Michałowskiego	ulica
ulica Piotra Wysockiego	ulica
ulica Pirenejska	ulica
ulica Pisankowa	ulica
ulica Piskląt	ulica
ulica Piskorska	ulica
ulica Pistacjowa	ulica
ulica Pitagorasa	ulica
ulica Piwna	ulica
ulica Piwoniowa	ulica
ulica Plakatowa	ulica
ulica Planetowa	ulica
ulica Plantowa	ulica
ulica Plastyczna	ulica
ulica Platanowa	ulica
ulica Platanów	ulica
ulica Platynowa	ulica
ulica Plażowa	ulica
ulica Pląsy	ulica
ulica Pleciona	ulica
ulica Plutonowych	ulica
ulica Plutonu Armii Krajowej „Torpeda”	ulica
ulica Plutonu Armii Krajowej „Torpeda”	ulica
ulica Płaska	ulica
ulica Płatnerska	ulica
ulica Płatnicza	ulica
ulica Płatowcowa	ulica
ulica Płochocińska	ulica
ulica Płocka	ulica
ulica Płomyka	ulica
ulica Płońska	ulica
ulica Płowce	ulica
ulica Płowiecka	ulica
ulica Płudowska	ulica
ulica Płużańska	ulica
ulica Płużnicka	ulica
ulica Płyćwiańska	ulica
ulica Płytowa	ulica
ulica Pływacka	ulica
ulica Poborzańska	ulica
ulica Pobudki	ulica
ulica Pochyła	ulica
ulica Pochyła	ulica
ulica Pocieszeń	ulica
ulica Pociskowa	ulica
ulica Początkowa	ulica
ulica Pocztowa	ulica
ulica Poczty Gdańskiej	ulica
ulica Podbiałowa	ulica
ulica Podbipięty	ulica
ulica Podborska	ulica
ulica Podchorążych	ulica
ulica Podgórna	ulica
ulica Podgórska	ulica
ulica Podgrodzie	ulica
ulica Podgrzybków	ulica
ulica Podhajecka	ulica
ulica Podhalańska	ulica
ulica Podjazd	ulica
ulica Podkładowa	ulica
ulica Podkowińska	ulica
ulica Podkowy	ulica
ulica Podleśna	ulica
ulica Podłużna	ulica
ulica Podmiejska	ulica
ulica Podmokła	ulica
ulica Podobna	ulica
ulica Podolska	ulica
ulica Podpułkownika Mieczysława Sokołowskiego „Grzymały”	ulica
ulica Podpułkownika Stanisława Zygmunta Kiedacza	ulica
ulica Podpułkownika Wacława Szadkowskiego	ulica
ulica Podróżnicza	ulica
ulica Podskarbińska	ulica
ulica Podstarościch	ulica
ulica Podstawowa	ulica
ulica Podwale	ulica
ulica Podwójna	ulica
ulica Pod Kopcem	ulica
ulica Pod Lipą	ulica
ulica Pod Skocznią	ulica
ulica Pod Strzechą	ulica
ulica Poetów	ulica
ulica Poezji	ulica
ulica Pogodna	ulica
ulica Pograniczna	ulica
ulica Pokorna	ulica
ulica Pokrzywnicka	ulica
ulica Pokrzywowa	ulica
ulica Pokucka	ulica
ulica Polanicka	ulica
ulica Polanki	ulica
ulica Polany	ulica
ulica Polarna	ulica
ulica Poli Gojawiczyńskiej	ulica
ulica Poli Negri	ulica
ulica Poleczki	ulica
ulica Poleska	ulica
ulica Poligonowa	ulica
ulica Polinezyjska	ulica
ulica Polkowska	ulica
ulica Polnego Wiatru	ulica
ulica Polnej Róży	ulica
ulica Polna	ulica
ulica Polnych Kwiatów	ulica
ulica Poloneza	ulica
ulica Polska	ulica
ulica Polskich Skrzydeł	ulica
ulica Polskie Drogi	ulica
ulica Połaniecka	ulica
ulica Połączona	ulica
ulica Połczyńska	ulica
ulica Połoniny	ulica
ulica Południowa	ulica
ulica Pomarańczowa	ulica
ulica Pomianowska	ulica
ulica Pomidorowa	ulica
ulica Pomiechowska	ulica
ulica Pomocnicza	ulica
ulica Pomologiczna	ulica
ulica Pomorska	ulica
ulica Ponczowa	ulica
ulica Poniecka	ulica
ulica Pontonierów	ulica
ulica Popas	ulica
ulica Popiela	ulica
ulica Popiołów	ulica
ulica Popradzka	ulica
ulica Poprawna	ulica
ulica Popularna	ulica
ulica Porajów	ulica
ulica Poranek	ulica
ulica Porannej Bryzy	ulica
ulica Porannej Rosy	ulica
ulica Poranna	ulica
ulica Porcelanowa	ulica
ulica Porębska	ulica
ulica Poronińska	ulica
ulica Porostowa	ulica
ulica Portofino	ulica
ulica Portowa	ulica
ulica Pory	ulica
ulica Posag 7 Panien	ulica
ulica Posejdona	ulica
ulica Poselska	ulica
ulica Posłańców	ulica
ulica Pospieszna	ulica
ulica Pospolita	ulica
ulica Postępu	ulica
ulica Poświaty	ulica
ulica Poświętna	ulica
ulica Potażowa	ulica
ulica Potocka	ulica
ulica Potockich	ulica
ulica Potoki	ulica
ulica Potrzebna	ulica
ulica Potulicka	ulica
ulica Potułkały	ulica
ulica Powałów	ulica
ulica Powązkowska	ulica
ulica Powiatowa	ulica
ulica Powojowa	ulica
ulica Powroźnicza	ulica
ulica Powsińska	ulica
ulica Powstańców Śląskich	ulica
ulica Powstańców Warszawy	ulica
ulica Powstańców Wielkopolskich	ulica
ulica Powszechna	ulica
ulica Poziomkowa	ulica
ulica Poznańska	ulica
ulica Pozytywki	ulica
ulica Pożarowa	ulica
ulica Półksiężyca	ulica
ulica Północna	ulica
ulica Prabucka	ulica
ulica Prałatowska	ulica
ulica Praska	ulica
ulica Prasowa	ulica
ulica Pratulińska	ulica
ulica Prawdziwka	ulica
ulica Prawnicza	ulica
ulica Prażmowska	ulica
ulica Prezydencka	ulica
ulica Prętowa	ulica
ulica Prochowa	ulica
ulica Produkcyjna	ulica
ulica Profesorska	ulica
ulica Profesora Kazimierza Dąbrowskiego	ulica
ulica Prokuratorska	ulica
ulica Proletariatczyków	ulica
ulica Promenada	ulica
ulica Prometeusza	ulica
ulica Promienista	ulica
ulica Promienna	ulica
ulica Promykowa	ulica
ulica Prosta	ulica
ulica Protazego	ulica
ulica Prozy	ulica
ulica Próżna	ulica
ulica Prudnicka	ulica
ulica Pruszkowska	ulica
ulica Prymasa Andrzeja Krzyckiego	ulica
ulica Prymasa Jana Pawła Woronicza	ulica
ulica Prymasa Mikołaja Trąby	ulica
ulica Prymulki	ulica
ulica Pryzmaty	ulica
ulica Przasnyska	ulica
ulica Przaśna	ulica
ulica Prząśniczek	ulica
ulica Przebieg	ulica
ulica Przechodnia	ulica
ulica Przecławska	ulica
ulica Przecznica	ulica
ulica Przedatki	ulica
ulica Przednia	ulica
ulica Przedpole	ulica
ulica Przedświt	ulica
ulica Przedwiośnie	ulica
ulica Przejazdowa	ulica
ulica Przejazd	ulica
ulica Przekorna	ulica
ulica Przelot	ulica
ulica Przełęczy	ulica
ulica Przemian	ulica
ulica Przemyska	ulica
ulica Przemysłowa	ulica
ulica Przepiórki	ulica
ulica Przeskok	ulica
ulica Przesmyk	ulica
ulica Przewłocka	ulica
ulica Przewodników	ulica
ulica Przewodowa	ulica
ulica Przeworska	ulica
ulica Przeździecka	ulica
ulica Przodowników	ulica
ulica Przodowników Pracy	ulica
ulica Przyce	ulica
ulica Przyczółkowa	ulica
ulica Przydrożna	ulica
ulica Przygodna	ulica
ulica Przyjazna	ulica
ulica Przyjaźni	ulica
ulica Przyjemna	ulica
ulica Przykoszarowa	ulica
ulica Przylaszczkowa	ulica
ulica Przylesie	ulica
ulica Przyleśna	ulica
ulica Przyłęcka	ulica
ulica Przyokopowa	ulica
ulica Przyrodnicza	ulica
ulica Przyrynek	ulica
ulica Przyrzecze	ulica
ulica Przystaniowa	ulica
ulica Przytulna	ulica
ulica Przytyk	ulica
ulica Przy Agorze	ulica
ulica Przy Bażantarni	ulica
ulica Przy Bernardyńskiej Wodzie	ulica
ulica Przy Forcie	ulica
ulica Przy Grobli	ulica
ulica Przy Lasku	ulica
ulica Przy Parku	ulica
ulica Przy Wodzie	ulica
ulica Pstra	ulica
ulica Pszczyńska	ulica
ulica Pszeniczna	ulica
ulica Ptasia	ulica
ulica Ptysiowa	ulica
ulica Puchaczy	ulica
ulica Puchalska	ulica
ulica Puławska	ulica
ulica Pułkownika Stanisława Dąbka	ulica
ulica Pułkowa	ulica
ulica Pułku Armii Krajowej „Baszta”	ulica
ulica Pułku Armii Krajowej „Broda”	ulica
ulica Pułku Armii Krajowej „Waligóra”	ulica
ulica Pułku Armii Krajowej „Baszta”	ulica
ulica Pułku Armii Krajowej „Broda”	ulica
ulica Pułku Armii Krajowej „Waligóra”	ulica
ulica Pułtuska	ulica
ulica Pustelnicka	ulica
ulica Pustola	ulica
ulica Pustułeczki	ulica
ulica Puszczyka	ulica
ulica Puszczy Solskiej	ulica
ulica Puszkarzy	ulica
ulica Puzonistów	ulica
ulica Pyszniańska	ulica
ulica Rabarbarowa	ulica
ulica Rabatowa	ulica
ulica Rabczańska	ulica
ulica Rabindranatha Tagore	ulica
ulica Rabsztyńska	ulica
ulica Raciborska	ulica
ulica Racjonalizacji	ulica
ulica Racławicka	ulica
ulica Radarowa	ulica
ulica Radecka	ulica
ulica Radiowa	ulica
ulica Radłowska	ulica
ulica Radłowa	ulica
ulica Radna	ulica
ulica Radomska	ulica
ulica Radomszczańska	ulica
ulica Radosna	ulica
ulica Radoszycka	ulica
ulica Raduńska	ulica
ulica Radzanowska	ulica
ulica Radziejowicka	ulica
ulica Radziłowska	ulica
ulica Radziwie	ulica
ulica Radzymińska	ulica
ulica Rafaela	ulica
ulica Rafałowska	ulica
ulica Rafała Krajewskiego	ulica
ulica Rafii	ulica
ulica Rajców	ulica
ulica Rajgrodzka	ulica
ulica Rajmunda	ulica
ulica Rajska	ulica
ulica Rajskich Ptaków	ulica
ulica Rajszewska	ulica
ulica Rakietników	ulica
ulica Rakowiecka	ulica
ulica Ramowa	ulica
ulica Raniuszka	ulica
ulica Raperswilska	ulica
ulica Rasztowska	ulica
ulica Raszyńska	ulica
ulica Ratoszyńska	ulica
ulica Ratuszowa	ulica
ulica Ratyniecka	ulica
ulica Rawicka	ulica
ulica Rawska	ulica
ulica Rąblowska	ulica
ulica Rdestowa	ulica
ulica Rebusowa	ulica
ulica Redaktorska	ulica
ulica Redutowa	ulica
ulica Referendarska	ulica
ulica Regatowa	ulica
ulica Regionalna	ulica
ulica Regulska	ulica
ulica Rejonowa	ulica
ulica Rejowiecka	ulica
ulica Rejsu	ulica
ulica Rekrucka	ulica
ulica Rektorska	ulica
ulica Relaksowa	ulica
ulica Rembertowska	ulica
ulica Rembielińska	ulica
ulica Remiszewska	ulica
ulica Remontowa	ulica
ulica Renesansowa	ulica
ulica Renety	ulica
ulica Reniferowa	ulica
ulica Reprezentacyjna	ulica
ulica Republikańska	ulica
ulica Resorowa	ulica
ulica Reszelska	ulica
ulica Retmańska	ulica
ulica Rezedowa	ulica
ulica Rezerwowa	ulica
ulica Reżyserska	ulica
ulica Rębkowska	ulica
ulica Rękawicznicza	ulica
ulica Rękodzielnicza	ulica
ulica Rękopis	ulica
ulica Roalda Amundsena	ulica
ulica Robinii	ulica
ulica Robotnicza	ulica
ulica Rodła	ulica
ulica Rodowa	ulica
ulica Rodzinna	ulica
ulica Rodziny Hiszpańskich	ulica
ulica Rodziny Połanieckich	ulica
ulica Rodzynkowa	ulica
ulica Rogalińska	ulica
ulica Rogatkowa	ulica
ulica Rogowska	ulica
ulica Rohatyńska	ulica
ulica Rokitnicka	ulica
ulica Rokokowa	ulica
ulica Rokosowska	ulica
ulica Rolanda	ulica
ulica Rolnicza	ulica
ulica Rolna	ulica
ulica Romana i Jana Podoskich	ulica
ulica Romantyczna	ulica
ulica Romana Boguckiego	ulica
ulica Romana Maciejewskiego	ulica
ulica Romana Palestera	ulica
ulica Romana Pazińskiego	ulica
ulica Romana Popiołka	ulica
ulica Romana Sanguszki	ulica
ulica Romana Statkowskiego	ulica
ulica Romańska	ulica
ulica Romea i Julii	ulica
ulica Romualda Gutta	ulica
ulica Romualda Mielczarskiego	ulica
ulica Romualda Millera	ulica
ulica Romualda Traugutta	ulica
ulica Ropczycka	ulica
ulica Rosy Bailly	ulica
ulica Rosiczki	ulica
ulica Rosnąca	ulica
ulica Rosochata	ulica
ulica Rosy	ulica
ulica Rościszewska	ulica
ulica Roślinna	ulica
ulica Rotmistrzowska	ulica
ulica Rotmistrza Witolda Pileckiego	ulica
ulica Rotundy	ulica
ulica Roty	ulica
ulica Rowowa	ulica
ulica Rozalińska	ulica
ulica Rozbrat	ulica
ulica Rozchodnikowa	ulica
ulica Rozewska	ulica
ulica Rozkoszna	ulica
ulica Rozłączona	ulica
ulica Rozłogi	ulica
ulica Rozłucka	ulica
ulica Rozmarynu	ulica
ulica Rozszerzona	ulica
ulica Roztocka	ulica
ulica Roztoki	ulica
ulica Rozwadowska	ulica
ulica Rożek	ulica
ulica Rożnowska	ulica
ulica Równoległa	ulica
ulica Równa	ulica
ulica Różana	ulica
ulica Róży Luksemburg	ulica
ulica Róży Wiatrów	ulica
ulica Rubinowa	ulica
ulica Ruchliwa	ulica
ulica Ruciańska	ulica
ulica Ruczaj	ulica
ulica Rudawska	ulica
ulica Rudzka	ulica
ulica Rumby	ulica
ulica Rumiankowa	ulica
ulica Rumiana	ulica
ulica Rumuńska	ulica
ulica Rusałki	ulica
ulica Rusiecka	ulica
ulica Rusinowska	ulica
ulica Ruskowy Bród	ulica
ulica Rusznikarska	ulica
ulica Ruty	ulica
ulica Rybałtów	ulica
ulica Rybieńska	ulica
ulica Rybitwy	ulica
ulica Rybnicka	ulica
ulica Rybna	ulica
ulica Rycerska	ulica
ulica Rycerstwa Polskiego	ulica
ulica Rychnowska	ulica
ulica Rydzowa	ulica
ulica Rydzyńska	ulica
ulica Rymanowska	ulica
ulica Rymarska	ulica
ulica Rynkowa	ulica
ulica Rypińska	ulica
ulica Rysia	ulica
ulica Rysy	ulica
ulica Rytelska	ulica
ulica Ryżowa	ulica
ulica Rzeczna	ulica
ulica Rzeczycka	ulica
ulica Rzekotki	ulica
ulica Rzemieślników	ulica
ulica Rzepichy	ulica
ulica Rzeszowska	ulica
ulica Rzewińska	ulica
ulica Rzeźbiarska	ulica
ulica Rzędziana	ulica
ulica Rzędzińska	ulica
ulica Rzodkiewki	ulica
ulica Rzymska	ulica
ulica Sabały	ulica
ulica Sadkowska	ulica
ulica Sadowa	ulica
ulica Sadulska	ulica
ulica Sady Żoliborskie	ulica
ulica Safony	ulica
ulica Sagalli	ulica
ulica Salamandry	ulica
ulica Salomejska	ulica
ulica Sałatkowa	ulica
ulica Samarytanka	ulica
ulica Samborska	ulica
ulica Samby	ulica
ulica Samochodowa	ulica
ulica Samogłoska	ulica
ulica Samolotowa	ulica
ulica Samorządowa	ulica
ulica Samosiejki	ulica
ulica Samotna	ulica
ulica Samowarowa	ulica
ulica Samsonowska	ulica
ulica Samuela Bogumiła Lindego	ulica
ulica Samuela Twardowskiego	ulica
ulica Sandomierska	ulica
ulica Sandora Petöfiego	ulica
ulica Sanocka	ulica
ulica Santocka	ulica
ulica Saperów	ulica
ulica Saperska	ulica
ulica Sapieżyńska	ulica
ulica Sarabandy	ulica
ulica Sardyńska	ulica
ulica Sarenki	ulica
ulica Sarmacka	ulica
ulica Sarmatów	ulica
ulica Sarny	ulica
ulica Sasanki	ulica
ulica Saska	ulica
ulica Sawy	ulica
ulica Sąchocka	ulica
ulica Sągi	ulica
ulica Sąsiedzka	ulica
ulica Sążnista	ulica
ulica Scholastyków	ulica
ulica Sebastiana Fabiana Klonowicza	ulica
ulica Secemińska	ulica
ulica Sejmikowa	ulica
ulica Sekundowa	ulica
ulica Sekwoi	ulica
ulica Seledynowa	ulica
ulica Semaforowa	ulica
ulica Senacka	ulica
ulica Senatorska	ulica
ulica Senna	ulica
ulica Serdeczna	ulica
ulica Serocka	ulica
ulica Serwituty	ulica
ulica Sewastopolska	ulica
ulica Sewerynów	ulica
ulica Seweryna Goszczyńskiego	ulica
ulica Seweryna Krzyżanowskiego	ulica
ulica Sezamkowa	ulica
ulica Sezam	ulica
ulica Sęczkowa	ulica
ulica Sędziowska	ulica
ulica Sękocińska	ulica
ulica Sępia	ulica
ulica Sępolińska	ulica
ulica Sianokosów	ulica
ulica Siarczana	ulica
ulica Sieciechowska	ulica
ulica Sieczna	ulica
ulica Siedlecka	ulica
ulica Siedliskowa	ulica
ulica Siedmiogrodzka	ulica
ulica Siedzibna	ulica
ulica Siekierkowska	ulica
ulica Sielanki	ulica
ulica Sielecka	ulica
ulica Sielska	ulica
ulica Siemiatycka	ulica
ulica Sieniawska	ulica
ulica Siennicka	ulica
ulica Sienna	ulica
ulica Sieradzka	ulica
ulica Sierpecka	ulica
ulica Siewierska	ulica
ulica Sikorska	ulica
ulica Siłaczki	ulica
ulica Simona Bolivara	ulica
ulica Siodlarska	ulica
ulica VII Poprzeczna	ulica
ulica Sitowie	ulica
ulica Skalbmierska	ulica
ulica Skalista	ulica
ulica Skalnicowa	ulica
ulica Skałacka	ulica
ulica Skarbka z Gór	ulica
ulica Skaryszewska	ulica
ulica Skazańców	ulica
ulica Skibicka	ulica
ulica Skierdowska	ulica
ulica Skierniewicka	ulica
ulica Sklepowa	ulica
ulica Składowa	ulica
ulica Skłoby	ulica
ulica Skoczna	ulica
ulica Skokowa	ulica
ulica Skolimowska	ulica
ulica Skoroszewska	ulica
ulica Skorpiona	ulica
ulica Skotnicka	ulica
ulica Skowronkowa	ulica
ulica Skrajna	ulica
ulica Skromna	ulica
ulica Skrzetuskiego	ulica
ulica Skrzydlata	ulica
ulica Skrzypcowa	ulica
ulica Skrzypów	ulica
ulica Skuterowa	ulica
ulica Skwierzyńska	ulica
ulica Sławińska	ulica
ulica Sławkowska	ulica
ulica Słodka	ulica
ulica Słodowiecka	ulica
ulica Słodowiec	ulica
ulica Słomiana	ulica
ulica Słonecznej Polany	ulica
ulica Słonecznikowa	ulica
ulica Słoneczna	ulica
ulica Słonki	ulica
ulica Słotna	ulica
ulica Słowicza	ulica
ulica Słubicka	ulica
ulica Słupecka	ulica
ulica Słupska	ulica
ulica Służby Polsce	ulica
ulica Służewska	ulica
ulica Smardzewska	ulica
ulica Smocza	ulica
ulica Smogorska	ulica
ulica Smogulecka	ulica
ulica Smoleńska	ulica
ulica Smolna	ulica
ulica Smoszewska	ulica
ulica Smugowa	ulica
ulica Smyczkowa	ulica
ulica Snopowa	ulica
ulica Snycerska	ulica
ulica Sobiborska	ulica
ulica Sobierajska	ulica
ulica Sobieszyńska	ulica
ulica Sobocka	ulica
ulica Sobolewska	ulica
ulica Sobótki	ulica
ulica Sochaczewska	ulica
ulica Soczewkowa	ulica
ulica Soczi	ulica
ulica Sokola	ulica
ulica Sokołowska	ulica
ulica Sokratesa	ulica
ulica Solankowa	ulica
ulica Solec	ulica
ulica Solferino	ulica
ulica Solidna	ulica
ulica Solińska	ulica
ulica Solipska	ulica
ulica Solistów	ulica
ulica Solurska	ulica
ulica Sonaty	ulica
ulica Soplicka	ulica
ulica Sopocka	ulica
ulica Sortowa	ulica
ulica Sosnowiecka	ulica
ulica Sosnowa	ulica
ulica Sowia	ulica
ulica Sowizdrzała	ulica
ulica Sozopolska	ulica
ulica Sójki	ulica
ulica Spacerowa	ulica
ulica Spadkowa	ulica
ulica Spadowa	ulica
ulica Spalinowa	ulica
ulica Spalska	ulica
ulica Spartakusa	ulica
ulica Spartańska	ulica
ulica Spedycyjna	ulica
ulica Spichrzowa	ulica
ulica Spiralna	ulica
ulica Spiska	ulica
ulica Spokojna	ulica
ulica Sporna	ulica
ulica Sportowa	ulica
ulica Sporyszowa	ulica
ulica Spójni	ulica
ulica Spółdzielcza	ulica
ulica Sprawna	ulica
ulica Sprzeczna	ulica
ulica Spychowska	ulica
ulica Spytka z Melsztyna	ulica
ulica Srebrnogórska	ulica
ulica Srebrna	ulica
ulica Stadionowa	ulica
ulica Stajenna	ulica
ulica Stalowa	ulica
ulica Staniewicka	ulica
ulica Stanisławowska	ulica
ulica Stanisława Augusta Poniatowskiego	ulica
ulica Stanisława Barcewicza	ulica
ulica Stanisława Barei	ulica
ulica Stanisława Bodycha	ulica
ulica Stanisława Chudoby	ulica
ulica Stanisława Dubois	ulica
ulica Stanisława Grochowiaka	ulica
ulica Stanisława Grzesiuka	ulica
ulica Stanisława Hempla	ulica
ulica Stanisława Herbsta	ulica
ulica Stanisława Jachowicza	ulica
ulica Stanisława Jagmina	ulica
ulica Stanisława Kazury	ulica
ulica Stanisława Kierbedzia	ulica
ulica Stanisława Konarskiego	ulica
ulica Stanisława Kostki Potockiego	ulica
ulica Stanisława Krupki	ulica
ulica Stanisława Kulczyńskiego	ulica
ulica Stanisława Kunickiego	ulica
ulica Stanisława Lencewicza	ulica
ulica Stanisława Lentza	ulica
ulica Stanisława Ligonia	ulica
ulica Stanisława Mikołajczyka	ulica
ulica Stanisława Miłkowskiego	ulica
ulica Stanisława Moniuszki	ulica
ulica Stanisława Noakowskiego	ulica
ulica Stanisława Przybyszewskiego	ulica
ulica Stanisława Rogalskiego	ulica
ulica Stanisława Rychlińskiego	ulica
ulica Stanisława Skarżyńskiego	ulica
ulica Stanisława Skrońskiego	ulica
ulica Stanisława Skrypija	ulica
ulica Stanisława Smolki	ulica
ulica Stanisława Staszica	ulica
ulica Stanisława Szczepanowskiego	ulica
ulica Stanisława Szobera	ulica
ulica Stanisława Tołwińskiego	ulica
ulica Stanisława Wigury	ulica
ulica Stanisława Witkiewicza	ulica
ulica Stanisława Wojciechowskiego	ulica
ulica Stanisława Worcella	ulica
ulica Stanisława Wrońskiego	ulica
ulica Stanisława Wyspiańskiego	ulica
ulica Stanisława Żaryna	ulica
ulica Stanisława Żółkiewskiego	ulica
ulica Starczewska	ulica
ulica Starego Dębu	ulica
ulica Starego Doktora	ulica
ulica Starej Baśni	ulica
ulica Starej Gruszy	ulica
ulica Stargardzka	ulica
ulica Starodawna	ulica
ulica Starodęby	ulica
ulica Staropolska	ulica
ulica Starościńska	ulica
ulica Starowiejska	ulica
ulica Starozaciszańska	ulica
ulica Startowa	ulica
ulica Stara	ulica
ulica Stasinek	ulica
ulica Staszowska	ulica
ulica Statyczna	ulica
ulica Stawiszyńska	ulica
ulica Stawki	ulica
ulica Stawowa	ulica
ulica Stawy	ulica
ulica Stągiewna	ulica
ulica Stefanii Sempołowskiej	ulica
ulica Stefana Baleya	ulica
ulica Stefana Banacha	ulica
ulica Stefana Berenta	ulica
ulica Stefana Bobrowskiego	ulica
ulica Stefana Bryły	ulica
ulica Stefana Dembego	ulica
ulica Stefana Drzewieckiego	ulica
ulica Stefana Jaracza	ulica
ulica Stefana Kazimierza Hankiewicza	ulica
ulica Stefana Kopcińskiego	ulica
ulica Stefana Królikowskiego	ulica
ulica Stefana Łyszkiewicza „Pechowca”	ulica
ulica Stefana Okrzei	ulica
ulica Stefana Pieńkowskiego	ulica
ulica Stefana Pogonowskiego	ulica
ulica Stefana Starzyńskiego	ulica
ulica Stefana Szolc-Rogozińskiego	ulica
ulica Stefana Żeromskiego	ulica
ulica Stelmachów	ulica
ulica Stepowa	ulica
ulica Sterdyńska	ulica
ulica Sternicza	ulica
ulica Stębarska	ulica
ulica Stępińska	ulica
ulica Stężycka	ulica
ulica Stocka	ulica
ulica Stoczkowska	ulica
ulica Stoczniowców	ulica
ulica Stogi	ulica
ulica Stoicka	ulica
ulica Stojanowska	ulica
ulica Stokłosy	ulica
ulica Stokrotki	ulica
ulica Stolarska	ulica
ulica Stołeczna	ulica
ulica Stopowa	ulica
ulica Storczykowa	ulica
ulica Stradomska	ulica
ulica Strawczyńska	ulica
ulica Strażacka	ulica
ulica Strąkowa	ulica
ulica Stroma	ulica
ulica Strońska	ulica
ulica Strubiczów	ulica
ulica Strumykowa	ulica
ulica Strunowa	ulica
ulica Strusia	ulica
ulica Strycharska	ulica
ulica Stryjeńskich	ulica
ulica Strzegomska	ulica
ulica Strzelca	ulica
ulica Strzelców	ulica
ulica Strzelecka	ulica
ulica Strzelińska	ulica
ulica Strzybnicka	ulica
ulica Strzygłowska	ulica
ulica Studencka	ulica
ulica Studzienna	ulica
ulica Stylowa	ulica
ulica Styrska	ulica
ulica Suchocińska	ulica
ulica Suchodolska	ulica
ulica Sucha	ulica
ulica Suchy Las	ulica
ulica Sueska	ulica
ulica Suflerska	ulica
ulica Sulejkowska	ulica
ulica Sulęcińska	ulica
ulica Sulimy	ulica
ulica Sulmierzycka	ulica
ulica Sułkowicka	ulica
ulica Sumaków	ulica
ulica Suwak	ulica
ulica Suwalska	ulica
ulica Swarożyca	ulica
ulica Swarzewska	ulica
ulica Swojska	ulica
ulica Sworzniowa	ulica
ulica Swoszowicka	ulica
ulica Sybilli	ulica
ulica Sycowska	ulica
ulica Sycylijska	ulica
ulica Sygnałowa	ulica
ulica Sylwestra Bartosika	ulica
ulica Symfonii	ulica
ulica Sympatyczna	ulica
ulica Synogarlicy	ulica
ulica Synów Pułku	ulica
ulica Sypniewska	ulica
ulica Syreny	ulica
ulica Syryńska	ulica
ulica Syta	ulica
ulica Szachowa	ulica
ulica Szafarzy	ulica
ulica Szafirków	ulica
ulica Szafirowa	ulica
ulica Szaflarska	ulica
ulica Szafranowa	ulica
ulica Szafranów	ulica
ulica Szafrańców	ulica
ulica Szalejowa	ulica
ulica Szałwiowa	ulica
ulica Szamocin	ulica
ulica Szamocka	ulica
ulica Szamotulska	ulica
ulica Szamoty	ulica
ulica Szańcowa	ulica
ulica Szarady	ulica
ulica Szarotki	ulica
ulica Szara	ulica
ulica Szarych Szeregów	ulica
ulica Szaserów	ulica
ulica Szatkowników	ulica
ulica Szawelska	ulica
ulica Szczawnicka	ulica
ulica Szczekocińska	ulica
ulica Szczepana Grzeszczyka	ulica
ulica Szczerbca	ulica
ulica Szczera	ulica
ulica Szczęsna	ulica
ulica Szczęśliwicka	ulica
ulica Szczęśliwa	ulica
ulica Szczotkarska	ulica
ulica Szczuczyńska	ulica
ulica Szczupacza	ulica
ulica Szczygla	ulica
ulica Szczytnowska	ulica
ulica Szczytowa	ulica
ulica Szegedyńska	ulica
ulica Szeligowska	ulica
ulica Szepietowska	ulica
ulica Szermiercza	ulica
ulica Szeroka	ulica
ulica Szeroki Dunaj	ulica
ulica Szewska	ulica
ulica Szklana	ulica
ulica Szklanych Domów	ulica
ulica Szklarniowa	ulica
ulica Szkolna	ulica
ulica Szkoły Orląt	ulica
ulica Szkutników	ulica
ulica Szlachecka	ulica
ulica Szlenkierów	ulica
ulica Szlifierska	ulica
ulica Szmaragdowa	ulica
ulica Szoferska	ulica
ulica Szosowa	ulica
ulica VI Poprzeczna	ulica
ulica Szpacza	ulica
ulica Szparagowa	ulica
ulica Szpinakowa	ulica
ulica Szpitalna	ulica
ulica Szprotawska	ulica
ulica Szreniawska	ulica
ulica Sztabowa	ulica
ulica Sztajerka	ulica
ulica Sztormowa	ulica
ulica Sztukatorska	ulica
ulica Sztumska	ulica
ulica Szturmowa	ulica
ulica Sztygarów	ulica
ulica Szubińska	ulica
ulica Szulborska	ulica
ulica Szumiących Traw	ulica
ulica Szumiąca	ulica
ulica Szumna	ulica
ulica Szuwary	ulica
ulica Szwedzka	ulica
ulica Szwoleżerów	ulica
ulica Szybowcowa	ulica
ulica Szydłowiecka	ulica
ulica Szymanowska	ulica
ulica Szymbarska	ulica
ulica Szymona Askenazego	ulica
ulica Szymona Konarskiego	ulica
ulica Szymona Zimorowicza	ulica
ulica Szynowa	ulica
ulica Szyprów	ulica
ulica Szyszaków	ulica
ulica Szyszkowa	ulica
ulica Ścieżka	ulica
ulica Ślazowa	ulica
ulica Śląska	ulica
ulica Ślepa	ulica
ulica Ślimaka	ulica
ulica Śliska	ulica
ulica Śmiała	ulica
ulica Śmieszna	ulica
ulica Śmigielska	ulica
ulica Śmigłowca	ulica
ulica Śniardwy	ulica
ulica Śnieguliczki	ulica
ulica Śnieżna	ulica
ulica Śpiewaków	ulica
ulica Śpiewna	ulica
ulica Średnia	ulica
ulica Śreniawitów	ulica
ulica Środkowa	ulica
ulica Śródborowska	ulica
ulica Śródziemnomorska	ulica
ulica Światowida	ulica
ulica Światowa	ulica
ulica Świderska	ulica
ulica Świdnicka	ulica
ulica Świebodzińska	ulica
ulica Świecka	ulica
ulica Świeradowska	ulica
ulica Świerkowa	ulica
ulica Świerszcza	ulica
ulica Świetlana	ulica
ulica Świetlicka	ulica
ulica Świetlików	ulica
ulica Świetlista	ulica
ulica Świeża	ulica
ulica Święciańska	ulica
ulica Świętej Barbary	ulica
ulica Świętej Cecylii	ulica
ulica Świętej Marii Magdaleny	ulica
ulica Świętej Teresy	ulica
ulica Świętojańska	ulica
ulica Świętojerska	ulica
ulica Świętokrzyska	ulica
ulica Świętosławska	ulica
ulica Świętych Cyryla i Metodego	ulica
ulica Świętego Andrzeja Boboli	ulica
ulica Świętego Bonifacego	ulica
ulica Świętego Franciszka Salezego	ulica
ulica Świętego Hieronima	ulica
ulica Świętego Jacka Odrowąża	ulica
ulica Świętego Maksymiliana Kolbego	ulica
ulica Świętego Patryka	ulica
ulica Świętego Stanisława	ulica
ulica Świętego Szczepana	ulica
ulica Świętego Wincentego	ulica
ulica Świętego Wojciecha	ulica
ulica Świtezianki	ulica
ulica Taborowa	ulica
ulica Tadeusza Borowskiego	ulica
ulica Tadeusza Boya-Żeleńskiego	ulica
ulica Tadeusza Czackiego	ulica
ulica Tadeusza Gajcego	ulica
ulica Tadeusza Hennela	ulica
ulica Tadeusza Hołówki	ulica
ulica Tadeusza Joteyki	ulica
ulica Tadeusza Korzona	ulica
ulica Tadeusza Krępowieckiego	ulica
ulica Tadeusza Kulisiewicza	ulica
ulica Tadeusza Makowskiego	ulica
ulica Tadeusza Manteuffla	ulica
ulica Tadeusza Rechniewskiego	ulica
ulica Tadeusza Regera	ulica
ulica Tadeusza Rejtana	ulica
ulica Tadeusza Sygietyńskiego	ulica
ulica Tadeusza Żarskiego	ulica
ulica Tadżycka	ulica
ulica Talarowa	ulica
ulica Tamaryszków	ulica
ulica Tamka	ulica
ulica Taneczna	ulica
ulica Tango	ulica
ulica Tapetowa	ulica
ulica Tapicerska	ulica
ulica Tarasowa	ulica
ulica Tarchomińska	ulica
ulica Tarczowa	ulica
ulica Tarczyńska	ulica
ulica Targowa	ulica
ulica Tarniny	ulica
ulica Tarnobrzeska	ulica
ulica Tarnogórska	ulica
ulica Tarnowiecka	ulica
ulica Tasznikowa	ulica
ulica Taśmowa	ulica
ulica Tatarska	ulica
ulica Tatrzańska	ulica
ulica Tawerny	ulica
ulica Tawułkowa	ulica
ulica Tczewska	ulica
ulica Techniczna	ulica
ulica Techników	ulica
ulica Telefoniczna	ulica
ulica Telewizyjna	ulica
ulica Telimeny	ulica
ulica Tenisowa	ulica
ulica Teodora Axentowicza	ulica
ulica Teodora Duracza	ulica
ulica Teodora Toeplitza	ulica
ulica Teodozji	ulica
ulica Teofila Jaśkiewicza	ulica
ulica Teofila Lenartowicza	ulica
ulica Teofila Piecyka	ulica
ulica Teresińska	ulica
ulica Terespolska	ulica
ulica Tęczowa	ulica
ulica Tkaczy	ulica
ulica Tłomackie	ulica
ulica Tłuchowska	ulica
ulica Tokarska	ulica
ulica Tomaszowska	ulica
ulica Tomasza Edisona	ulica
ulica Tomasza Nocznickiego	ulica
ulica Tomasza Zana	ulica
ulica Tomcia Palucha	ulica
ulica Tomnicka	ulica
ulica Topazowa	ulica
ulica Topiel	ulica
ulica Topograficzna	ulica
ulica Topolowa	ulica
ulica Toporczyków	ulica
ulica Toporowska	ulica
ulica Torfowa	ulica
ulica Torowa	ulica
ulica Toruńska	ulica
ulica Towarowa	ulica
ulica Traczy	ulica
ulica Traktorzystki	ulica
ulica Traktorzystów	ulica
ulica Tramblanki	ulica
ulica Tramwajowa	ulica
ulica Transportowców	ulica
ulica Trapez	ulica
ulica Traszki	ulica
ulica Trawiasta	ulica
ulica Trele	ulica
ulica Trembowelska	ulica
ulica Trenów	ulica
ulica Trębacka	ulica
ulica Tristana	ulica
ulica Trocinowa	ulica
ulica Trocka	ulica
ulica Trojaka	ulica
ulica Trojanowska	ulica
ulica Trojańska	ulica
ulica Trombity	ulica
ulica Trójpolowa	ulica
ulica Trufle	ulica
ulica Truskawiecka	ulica
ulica Truskolaska	ulica
ulica Trybunalska	ulica
ulica Trylogii	ulica
ulica Trzcinowa	ulica
ulica Trzebnicka	ulica
ulica Trzech Budrysów	ulica
ulica III Poprzeczna	ulica
ulica Trzos	ulica
ulica Trzykrotki	ulica
ulica Tuberozy	ulica
ulica Tuchlińska	ulica
ulica Tucholska	ulica
ulica Tukana	ulica
ulica Tulipanowa	ulica
ulica Tułowicka	ulica
ulica Tumska	ulica
ulica Tunelowa	ulica
ulica Turbinowa	ulica
ulica Turecka	ulica
ulica Turkawki	ulica
ulica Turkusowa	ulica
ulica Turmoncka	ulica
ulica Turniejowa	ulica
ulica Turoszowska	ulica
ulica Turystyczna	ulica
ulica Tuzinowa	ulica
ulica Tużycka	ulica
ulica Twardowska	ulica
ulica Twarda	ulica
ulica Twórcza	ulica
ulica Tykocińska	ulica
ulica Tylmana Gamerskiego	ulica
ulica Tylna	ulica
ulica Tylżycka	ulica
ulica Tymiankowa	ulica
ulica Tymotki	ulica
ulica Tyniecka	ulica
ulica Tynkarska	ulica
ulica Tyrreńska	ulica
ulica Tyszowiecka	ulica
ulica Tyśmienicka	ulica
ulica Tytoniowa	ulica
ulica Tytułowa	ulica
ulica Tytusa Chałubińskiego	ulica
ulica Uczniowska	ulica
ulica Uczonych	ulica
ulica Ugorek	ulica
ulica Uhrocie	ulica
ulica Ukośna	ulica
ulica Ukryta	ulica
ulica Ulanowska	ulica
ulica Ulrychowska	ulica
ulica Ułanów Krechowieckich	ulica
ulica Ułańska	ulica
ulica Umowna	ulica
ulica Uniejowska	ulica
ulica Uniwersału	ulica
ulica Uniwersytecka	ulica
ulica Uprawna	ulica
ulica Uranowa	ulica
ulica Urbanistów	ulica
ulica Urle	ulica
ulica Urocza	ulica
ulica Uroczysko	ulica
ulica Urodzajna	ulica
ulica Ursynowska	ulica
ulica Urszuli	ulica
ulica Urugwajska	ulica
ulica Urwisko	ulica
ulica Urzędnicza	ulica
ulica Ustronie	ulica
ulica Ustronna	ulica
ulica Ustrzycka	ulica
ulica Usypiskowa	ulica
ulica Uśmiech	ulica
ulica Utrata	ulica
ulica Uzdowska	ulica
ulica Uznamska	ulica
ulica V Poprzeczna	ulica
ulica VI Poprzeczna	ulica
ulica VII Poprzeczna	ulica
ulica VIII Poprzeczna	ulica
ulica VIII Poprzeczna	ulica
ulica VII Poprzeczna	ulica
ulica Villardczyków	ulica
ulica Vincenta van Gogha	ulica
ulica VI Poprzeczna	ulica
ulica V Poprzeczna	ulica
ulica Wacława Berenta	ulica
ulica Wacława Borowego	ulica
ulica Wacława Gąsiorowskiego	ulica
ulica Wacława Lachmana	ulica
ulica Wacława Paszkowskiego	ulica
ulica Wacława Sieroszewskiego	ulica
ulica Wacława Sierpińskiego	ulica
ulica Wacława Tokarza	ulica
ulica Wacława Żenczykowskiego	ulica
ulica Wadowicka	ulica
ulica Waflowa	ulica
ulica Wagonowa	ulica
ulica Wahadło	ulica
ulica Wakacyjna	ulica
ulica Waksmundzka	ulica
ulica Walcownicza	ulica
ulica Walczyka	ulica
ulica Walecznych	ulica
ulica Walentego Skorochód-Majewskiego	ulica
ulica Waleriana Łukasińskiego	ulica
ulica Walerego Bagińskiego	ulica
ulica Walerego Sławka	ulica
ulica Walewska	ulica
ulica Waliców	ulica
ulica Waligóry	ulica
ulica Wallenroda	ulica
ulica Wałbrzyska	ulica
ulica Wałowicka	ulica
ulica Wałowa	ulica
ulica Wałuszewska	ulica
ulica Wał Kościuszkowski	ulica
ulica Wał Miedzeszyński	ulica
ulica Wał Zawadowski	ulica
ulica Wandy Rutkiewicz	ulica
ulica Wandy Wasilewskiej	ulica
ulica Wandy Zieleńczyk	ulica
ulica Wandy	ulica
ulica Waniliowa	ulica
ulica Wantule	ulica
ulica Wapienna	ulica
ulica Warecka	ulica
ulica Warneńska	ulica
ulica Warowna	ulica
ulica Warsa	ulica
ulica Warszawska	ulica
ulica Warsztatowa	ulica
ulica Wartka	ulica
ulica Warzelnicza	ulica
ulica Wasilkowska	ulica
ulica Wawelska	ulica
ulica Wawerska	ulica
ulica Wawrzyńca Surowieckiego	ulica
ulica Wawrzyńca Żuławskiego	ulica
ulica Wawrzynowa	ulica
ulica Wawrzyszewska	ulica
ulica Wazów	ulica
ulica Wąbrzeska	ulica
ulica Wąchocka	ulica
ulica Wągrowiecka	ulica
ulica Wąska	ulica
ulica Wąski Dunaj	ulica
ulica Wąwolnicka	ulica
ulica Wąwozowa	ulica
ulica Wczasowa	ulica
ulica Wczele	ulica
ulica Wejherowska	ulica
ulica Wełniana	ulica
ulica Wenantego Burdzińskiego	ulica
ulica Wenecka	ulica
ulica Wenedów	ulica
ulica Werandowa	ulica
ulica Wery Kostrzewy	ulica
ulica Werbeny	ulica
ulica Wergiliusza	ulica
ulica Wernyhory	ulica
ulica Wersalska	ulica
ulica Weselna	ulica
ulica Wesoła	ulica
ulica Wespazjana Kochowskiego	ulica
ulica Westerplatte	ulica
ulica Weteranów	ulica
ulica Weterynaryjna	ulica
ulica Wędkarska	ulica
ulica Wędrowców	ulica
ulica Węgierska	ulica
ulica Węglarska	ulica
ulica Węgorzewska	ulica
ulica Węgrowska	ulica
ulica Wiartel	ulica
ulica Wiarusów	ulica
ulica Wiatraczna	ulica
ulica Wiązana	ulica
ulica Wiązowska	ulica
ulica Wiązów	ulica
ulica Wichrowa	ulica
ulica Widawska	ulica
ulica Widna	ulica
ulica Widoczna	ulica
ulica Widokowa	ulica
ulica Widok	ulica
ulica Widzewska	ulica
ulica Wiechy	ulica
ulica Wieczorowa	ulica
ulica Wiejska	ulica
ulica Wielbarska	ulica
ulica Wielicka	ulica
ulica Wieliszewska	ulica
ulica Wielkiego Dębu	ulica
ulica Wielostronna	ulica
ulica Wielowiejska	ulica
ulica Wieluńska	ulica
ulica Wieniecka	ulica
ulica Wierchów	ulica
ulica Wierna	ulica
ulica Wiertnicza	ulica
ulica Wierzbiny	ulica
ulica Wierzbowa	ulica
ulica Wierzby	ulica
ulica Wiesiołka	ulica
ulica Wieśniacza	ulica
ulica Wiewiórki	ulica
ulica Wieżowa	ulica
ulica Wikingów	ulica
ulica Wiklinowa	ulica
ulica Wiktorii Kaweckiej	ulica
ulica Wiktorii Wiedeńskiej	ulica
ulica Wiktorska	ulica
ulica Wiktora Białego	ulica
ulica Wiktora Gomulickiego	ulica
ulica Wilanowska	ulica
ulica Wilczej Łąki	ulica
ulica Wilcza	ulica
ulica Wilczycka	ulica
ulica Wilczy Dół	ulica
ulica Wileńska	ulica
ulica Wilgi	ulica
ulica Wilhelma Konrada Roentgena	ulica
ulica Wilkowiecka	ulica
ulica Wilków Morskich	ulica
ulica Williama Heerleina Lindleya	ulica
ulica Williama Szekspira	ulica
ulica Willowa	ulica
ulica Wincentego Pola	ulica
ulica Wincentego Pstrowskiego	ulica
ulica Wincentego Pstrowskiego	ulica
ulica Wincentego Rapackiego	ulica
ulica Wincentego Rzymowskiego	ulica
ulica Winiarska	ulica
ulica Winnicka	ulica
ulica Winorośli	ulica
ulica Wiolinowa	ulica
ulica Wiolonczeli	ulica
ulica Wiosenna	ulica
ulica Wiosny Ludów	ulica
ulica Wioślarska	ulica
ulica Wirażowa	ulica
ulica Wisełki	ulica
ulica Wisienki	ulica
ulica Wiślanego Nurtu	ulica
ulica Wiślana	ulica
ulica Wiślicka	ulica
ulica Wiśniowa	ulica
ulica Witebska	ulica
ulica Witki	ulica
ulica Witolda Doroszewskiego	ulica
ulica Witolda Gombrowicza	ulica
ulica Witolda Lutosławskiego	ulica
ulica Witolda Małcużyńskiego	ulica
ulica Witolda Pogorzelskiego	ulica
ulica Witolda Rychtera	ulica
ulica Witolda Trylskiego	ulica
ulica Witolda Wierzbickiego	ulica
ulica Witolda Zawadowskiego	ulica
ulica Witolińska	ulica
ulica Wita Stwosza	ulica
ulica Wjazdowa	ulica
ulica Władimira Komarowa	ulica
ulica Władysławowska	ulica
ulica Władysława Bełzy	ulica
ulica Władysława Bieńczaka	ulica
ulica Władysława Broniewskiego	ulica
ulica Władysława Hańczy	ulica
ulica Władysława Hassa	ulica
ulica Władysława Hibnera	ulica
ulica Władysława Jana Grabskiego	ulica
ulica Władysława Korotyńskiego	ulica
ulica Władysława Lercha	ulica
ulica Władysława Niegolewskiego	ulica
ulica Władysława Okińskiego	ulica
ulica Władysława Orkana	ulica
ulica Władysława Przanowskiego	ulica
ulica Władysława Pytlasińskiego	ulica
ulica Władysława Reymonta	ulica
ulica Władysława Skoczylasa	ulica
ulica Władysława Smoleńskiego	ulica
ulica Władysława Spasowskiego	ulica
ulica Władysława Syrokomli	ulica
ulica Władysława Szernera	ulica
ulica Władysława Tatarkiewicza	ulica
ulica Władysława Umińskiego	ulica
ulica Władysława Witwickiego	ulica
ulica Władysława Żeleńskiego	ulica
ulica Włochowska	ulica
ulica Włodarzewska	ulica
ulica Włodzicka	ulica
ulica Włodzimierza Dolańskiego	ulica
ulica Włodzimierza Kołosa	ulica
ulica Włodzimierza Majakowskiego	ulica
ulica Włodzimierza Perzyńskiego	ulica
ulica Włodzimierza Przerwy-Tetmajera	ulica
ulica Włodzimierza Skalmowskiego	ulica
ulica Włoska	ulica
ulica Włościańska	ulica
ulica Włókiennicza	ulica
ulica Włóki	ulica
ulica Wodniaków	ulica
ulica Wodna	ulica
ulica Wodyńska	ulica
ulica Wodzirejów	ulica
ulica Wodzisławska	ulica
ulica Wojciecha Bogumiła Jastrzębowskiego	ulica
ulica Wojciecha Bogusławskiego	ulica
ulica Wojciecha Chrzanowskiego	ulica
ulica Wojciecha Gersona	ulica
ulica Wojciecha Górskiego	ulica
ulica Wojciecha Korfantego	ulica
ulica Wojciecha Oczki	ulica
ulica Wojciecha Świętosławskiego	ulica
ulica Wojciecha Żywnego	ulica
ulica Wojdyńska	ulica
ulica Wojnicka	ulica
ulica Wojskowej Służby Kobiet	ulica
ulica Wojskowa	ulica
ulica Wojsławicka	ulica
ulica Wokalna	ulica
ulica Wolborska	ulica
ulica Wolbromska	ulica
ulica Wolęcińska	ulica
ulica Wolfganga Amadeusza Mozarta	ulica
ulica Wolicka	ulica
ulica Wolińska	ulica
ulica Wolnej Wszechnicy	ulica
ulica Wolności	ulica
ulica Wolność	ulica
ulica Wolna	ulica
ulica Wolska	ulica
ulica Wolumen	ulica
ulica Wołomińska	ulica
ulica Wołoska	ulica
ulica Woziwody	ulica
ulica Wójcicka	ulica
ulica Wójtowska	ulica
ulica Wólczyńska	ulica
ulica Wrocławska	ulica
ulica Wronia	ulica
ulica Wrotkowa	ulica
ulica Wróbla	ulica
ulica Wrzeciono	ulica
ulica Wrzesińska	ulica
ulica Wrzosowisko	ulica
ulica Wrzosowa	ulica
ulica Wschodnia	ulica
ulica Wschowska	ulica
ulica Wspomnień	ulica
ulica Wspólna Droga	ulica
ulica Wspólna	ulica
ulica Współczesna	ulica
ulica Wszeborska	ulica
ulica Wszemirowska	ulica
ulica Wybieg	ulica
ulica Wyborna	ulica
ulica Wybrańska	ulica
ulica Wybrzeże Gdańskie	ulica
ulica Wybrzeże Gdyńskie	ulica
ulica Wybrzeże Helskie	ulica
ulica Wybrzeże Kościuszkowskie	ulica
ulica Wybrzeże Szczecińskie	ulica
ulica Wycieczka	ulica
ulica Wyczółki	ulica
ulica Wydawnicza	ulica
ulica Wydmińska	ulica
ulica Wydmowa	ulica
ulica Wyganowska	ulica
ulica Wyględowska	ulica
ulica Wygoda	ulica
ulica Wygodna	ulica
ulica Wygon	ulica
ulica Wyjazd	ulica
ulica Wyjściowa	ulica
ulica Wykrot	ulica
ulica Wykusz	ulica
ulica Wylotowa	ulica
ulica Wylot	ulica
ulica Wynalazek	ulica
ulica Wypoczynkowa	ulica
ulica Wyprawa	ulica
ulica Wyrzyska	ulica
ulica Wysoczyńska	ulica
ulica Wysokomazowiecka	ulica
ulica Wysowska	ulica
ulica Wyspiarska	ulica
ulica Wyspowa	ulica
ulica Wyszatycka	ulica
ulica Wyszkowska	ulica
ulica Wyszogrodzka	ulica
ulica Wytworna	ulica
ulica Wzorcowa	ulica
ulica Wzorzysta	ulica
ulica X Poprzeczna	ulica
ulica Xawerego Dunikowskiego	ulica
ulica XI Poprzeczna	ulica
ulica XII Poprzeczna	ulica
ulica XII Poprzeczna	ulica
ulica XI Poprzeczna	ulica
ulica 21. Pułku Piechoty Dzieci Warszawy	ulica
ulica 20. Dywizji Piechoty Wojska Polskiego	ulica
ulica X Poprzeczna	ulica
ulica Zabawna	ulica
ulica Zabielska	ulica
ulica Zabłocińska	ulica
ulica Zabłocka	ulica
ulica Zabłudowska	ulica
ulica Zaboreczne	ulica
ulica Zaborowska	ulica
ulica Zabraniecka	ulica
ulica Zabrzańska	ulica
ulica Zachariasza	ulica
ulica Zachodnia	ulica
ulica Zachodu Słońca	ulica
ulica Zachodzącego Słońca	ulica
ulica Zaciszańska	ulica
ulica Zaciszna	ulica
ulica Zaczarowanej Dorożki	ulica
ulica Zadroże	ulica
ulica Zadrzewiona	ulica
ulica Zadumana	ulica
ulica Zagadki	ulica
ulica Zagaje	ulica
ulica Zagajnikowa	ulica
ulica Zagięta	ulica
ulica Zagłoby	ulica
ulica Zagorzycka	ulica
ulica Zagójska	ulica
ulica Zagórna	ulica
ulica Zagórzańska	ulica
ulica Zagraniczna	ulica
ulica Zagrodecka	ulica
ulica Zagrodowa	ulica
ulica Zajączkowska	ulica
ulica Zajęcza	ulica
ulica Zakamarek	ulica
ulica Zakątek	ulica
ulica Zakątna	ulica
ulica Zakładowa	ulica
ulica Zakole	ulica
ulica Zakopiańska	ulica
ulica Zakrętowa	ulica
ulica Zakręt	ulica
ulica Zakroczymska	ulica
ulica Zakrzewska	ulica
ulica Zalew	ulica
ulica Zalipie	ulica
ulica Załęże	ulica
ulica Załuski	ulica
ulica Zambrowska	ulica
ulica Zamglona	ulica
ulica Zamiany	ulica
ulica Zamiejska	ulica
ulica Zamieniecka	ulica
ulica Zamknięta	ulica
ulica Zaniemyska	ulica
ulica Zaokopowa	ulica
ulica Zaolziańska	ulica
ulica Zapałczana	ulica
ulica Zapiecek	ulica
ulica Zapłocie	ulica
ulica Zapole	ulica
ulica Zapomniana	ulica
ulica Zapustna	ulica
ulica Zaranie	ulica
ulica Zarębska	ulica
ulica Zarośla	ulica
ulica Zarzecze	ulica
ulica Zasadowa	ulica
ulica Zasieki	ulica
ulica Zasobna	ulica
ulica Zastępowa	ulica
ulica Zastowska	ulica
ulica Zastruże	ulica
ulica Zaściankowa	ulica
ulica Zatorze	ulica
ulica Zaułek	ulica
ulica Zawierciańska	ulica
ulica Zawilców	ulica
ulica Zawiszaków	ulica
ulica Zawiszy	ulica
ulica Zawiślańska	ulica
ulica Zawodowa	ulica
ulica Zawodzie	ulica
ulica Zawojska	ulica
ulica Zawrat	ulica
ulica Za Dębami	ulica
ulica Za Łąkami	ulica
ulica Ząbkowska	ulica
ulica Zbaraska	ulica
ulica Zbąszyńska	ulica
ulica Zbierska	ulica
ulica Zbigniewa Burzyńskiego	ulica
ulica Zbigniewa Gęsickiego „Juno”	ulica
ulica Zbigniewa Wasiutyńskiego	ulica
ulica Zbiorowa	ulica
ulica Zbocze	ulica
ulica Zbożowa	ulica
ulica Zbójnogórska	ulica
ulica Zbrojarska	ulica
ulica Zbyszka Cybulskiego	ulica
ulica Zbyszka z Bogdańca	ulica
ulica Zbytki	ulica
ulica Zdobnicza	ulica
ulica Zdrojowa	ulica
ulica Zdrowotna	ulica
ulica Zdrowa	ulica
ulica Zdziarska	ulica
ulica Zdzisława Mączeńskiego	ulica
ulica Zecerska	ulica
ulica Zegarowa	ulica
ulica Zegarynki	ulica
ulica Zegrzyńska	ulica
ulica Zenona Klemensiewicza	ulica
ulica Zerzeńska	ulica
ulica Zesłańców Polskich	ulica
ulica Zespołowa	ulica
ulica Zeusa	ulica
ulica Zgierska	ulica
ulica Zgoda	ulica
ulica Zgorzelecka	ulica
ulica Zgrupowania Armii Krajowej „Kampinos”	ulica
ulica Zgrupowania Armii Krajowej „Żmija”	ulica
ulica Zgrupowania Armii Krajowej „Żubr”	ulica
ulica Zgrupowania Armii Krajowej „Żyrafa”	ulica
ulica Zgrupowania Armii Krajowej „Kampinos”	ulica
ulica Zgrupowania Armii Krajowej „Żmija”	ulica
ulica Zgrupowania Armii Krajowej „Żubr”	ulica
ulica Zgrupowania Armii Krajowej „Żyrafa”	ulica
ulica Ziarnista	ulica
ulica Zielna	ulica
ulica Zielonej Gęsi	ulica
ulica Zielone Zacisze	ulica
ulica Zielonogórska	ulica
ulica Zielona	ulica
ulica Zielony Zagajnik	ulica
ulica Ziemiańska	ulica
ulica Ziębicka	ulica
ulica Zięby	ulica
ulica Zimna	ulica
ulica Zimorodka	ulica
ulica Zimowa	ulica
ulica Ziołowa	ulica
ulica Złocienia	ulica
ulica Złoczowska	ulica
ulica Złotego Smoka	ulica
ulica Złotej Jesieni	ulica
ulica Złotej Rybki	ulica
ulica Złotej Wilgi	ulica
ulica Złotopolska	ulica
ulica Złota	ulica
ulica Złotych Piasków	ulica
ulica Złoty Róg	ulica
ulica Zmyślona	ulica
ulica Znana	ulica
ulica Znicza	ulica
ulica Znicz	ulica
ulica Zodiakalna	ulica
ulica Zofii Nałkowskiej	ulica
ulica Zoltana Baló	ulica
ulica Zorzy	ulica
ulica Zręby	ulica
ulica Zwardońska	ulica
ulica Związkowa	ulica
ulica Związku Walki Młodych	ulica
ulica Zwierzyniecka	ulica
ulica Zwoleńska	ulica
ulica Zwrotnicza	ulica
ulica Zwycięzców	ulica
ulica Zygmuntowska	ulica
ulica Zygmunta Glogera	ulica
ulica Zygmunta Jórskiego	ulica
ulica Zygmunta Krasińskiego	ulica
ulica Zygmunta Markerta	ulica
ulica Zygmunta Modzelewskiego	ulica
ulica Zygmunta Noskowskiego	ulica
ulica Zygmunta Pawlaczyka	ulica
ulica Zygmunta Słomińskiego	ulica
ulica Zygmunta Stojowskiego	ulica
ulica Zygmunta Vogla	ulica
ulica Zyndrama z Maszkowic	ulica
ulica Źródlana	ulica
ulica Źródłowa	ulica
ulica Żaglowa	ulica
ulica Żakowska	ulica
ulica Żaluzji	ulica
ulica Żarecka	ulica
ulica Żarnowiecka	ulica
ulica Żbikowianka	ulica
ulica Żegańska	ulica
ulica Żegiestowska	ulica
ulica Żeglarska	ulica
ulica Żegoty	ulica
ulica Żelazna	ulica
ulica Żelazowska	ulica
ulica Żelechowska	ulica
ulica Żeńców	ulica
ulica Żerańska	ulica
ulica Żmigrodzka	ulica
ulica Żmudzka	ulica
ulica Żnińska	ulica
ulica Żniwna	ulica
ulica Żołędziowa	ulica
ulica Żołnierska	ulica
ulica Żołny	ulica
ulica Żonkilowa	ulica
ulica Żółkowskich	ulica
ulica Żółta	ulica
ulica Żółwia	ulica
ulica Żubowiecka	ulica
ulica Żubrowa	ulica
ulica Żuławska	ulica
ulica Żupnicza	ulica
ulica Żurawia	ulica
ulica Żurawicka	ulica
ulica Żurawiny	ulica
ulica Żuromińska	ulica
ulica Żużlowa	ulica
ulica Żwanowiecka	ulica
ulica Życzliwa	ulica
ulica Życzyńska	ulica
ulica Żyrardowska	ulica
ulica Żytnia	ulica
ulica Żytomierska	ulica
ulica Żywiczna	ulica
ulica Żywiecka	ulica
ulica Żywokostowa	ulica
ulica Żyzna	ulica
wiadukt Stanisława Markiewicza	wiadukt
szosa Lubelska	szosa
trakt Brzeski	trakt
trakt Lubelski	trakt
trakt Napoleoński	trakt
trasa Siekierkowska	trasa

